"year","month","airline","flight_arrivals","flight_departures","flight_total","passenger_arrivals","passenger_departures","passenger_total","cargo_arrivals","cargo_departures","cargo_total"
"2023","7",가루다인도네시아,23,23,46,3968,4776,8744,46,141,187
"2023","7",그레이터베이항공,18,18,36,2420,2473,4893,20,11,31
"2023","7",내셔널항공,1,1,2,0,0,0,0,100,100
"2023","7",대한항공,3478,3477,6955,586530,610795,1197325,53848,50540,104388
"2023","7",델타항공,124,124,248,32784,36777,69561,210,845,1055
"2023","7",디에이치엘항공,11,11,22,0,0,0,121,0,121
"2023","7",라오항공,22,22,44,2640,2812,5452,3,7,10
"2023","7",로얄브루나이항공,13,13,26,738,824,1562,0,7,7
"2023","7",롱하오항공,7,7,14,0,0,0,17,34,51
"2023","7",루프트한자 독일항공,102,102,204,18548,15638,34186,1028,1750,2778
"2023","7",말레이시아 항공,30,30,60,4525,6158,10683,198,290,489
"2023","7",몽골항공,99,99,198,14187,16957,31144,18,145,163
"2023","7",미얀마국제항공,13,13,26,1035,1303,2338,14,3,17
"2023","7",미얀마항공,8,8,16,1203,3,1206,1,2,3
"2023","7",바틱 에어 말레이시아,31,31,62,3879,4022,7901,0,0,0
"2023","7",뱀부 항공,25,25,50,4281,4593,8874,9,4,13
"2023","7",베트남항공,186,186,372,33638,38137,71775,1007,808,1815
"2023","7",비엣젯항공,465,465,930,89219,91825,181044,422,95,517
"2023","7",사우디아항공,18,17,35,4687,3698,8385,21,211,232
"2023","7",사천항공,13,13,26,1344,1389,2733,0,5,5
"2023","7",산동항공,218,218,436,25464,26680,52144,47,6,53
"2023","7",샤먼항공,30,30,60,4612,3879,8491,44,27,71
"2023","7",세부퍼시픽항공,106,106,212,14934,17737,32671,4,35,38
"2023","7",스리랑카항공,9,9,18,1665,1779,3444,46,86,132
"2023","7",스카이 앙코르 항공,16,16,32,2036,2422,4458,7,3,10
"2023","7",스쿠트 항공,40,40,80,11659,13214,24873,67,49,116
"2023","7",실크웨이웨스트항공,14,14,28,0,0,0,490,1100,1590
"2023","7",심천항공,52,52,104,5660,6103,11763,114,8,122
"2023","7",싱가포르항공,146,147,293,27871,34553,62424,1171,1476,2647
"2023","7",아메리제트,13,13,26,0,0,0,19,345,364
"2023","7",아메리칸항공,31,31,62,8205,8819,17024,92,266,358
"2023","7",아시아나항공,2018,2016,4034,370401,394576,764977,25523,24225,49748
"2023","7",아틀라스항공,164,172,336,128,134,262,3191,583,3774
"2023","7",에미레이트항공,31,31,62,14797,14569,29366,272,379,651
"2023","7",에바항공,78,78,156,16891,17722,34613,435,583,1017
"2023","7",에어 뉴질랜드,14,13,27,2231,3632,5863,30,172,202
"2023","7",에어 아스타나,27,27,54,5186,5468,10654,7,86,92
"2023","7",에어 프랑스,31,31,62,10102,9585,19687,346,321,667
"2023","7",에어로 몽골리아,15,15,30,1170,1330,2500,0,0,0
"2023","7",에어로로직,29,29,58,0,0,0,1326,114,1441
"2023","7",에어마카오,31,31,62,4247,4498,8745,16,10,25
"2023","7",에어부산,360,359,719,69698,70875,140573,0,0,0
"2023","7",에어서울,384,384,768,69950,72904,142854,38,0,38
"2023","7",에어아시아엑스,43,44,87,10558,13288,23846,283,329,612
"2023","7",에어인디아 리미티드,17,17,34,3205,3450,6655,61,194,255
"2023","7",에어인천,147,146,293,0,0,0,1615,1310,2925
"2023","7",에어캐나다,62,62,124,17873,18485,36358,737,764,1501
"2023","7",에어프레미아,129,129,258,37115,38526,75641,1021,885,1905
"2023","7",에어홍콩,26,26,52,0,0,0,1002,1185,2187
"2023","7",에티오피아항공,59,59,118,6166,5460,11626,987,312,1300
"2023","7",에티하드 항공,31,31,62,9797,8979,18776,319,448,767
"2023","7",우즈베키스탄항공,32,32,64,7017,6709,13726,5,235,240
"2023","7",유나이티드항공,62,62,124,14779,16484,31263,623,980,1604
"2023","7",유피에스항공,110,110,220,0,0,0,1651,2458,4108
"2023","7",이스타항공,2,0,2,378,0,378,0,0,0
"2023","7",전일본공수,22,22,44,0,0,0,596,885,1480
"2023","7",제주항공,1636,1632,3268,251702,263768,515470,1013,986,1998
"2023","7",젯스타,14,14,28,3266,4543,7809,5,79,84
"2023","7",중국국제항공,210,210,420,23533,21834,45367,32,51,83
"2023","7",중국남방항공,354,353,707,49122,53728,102850,321,131,452
"2023","7",중국동방항공,379,379,758,44410,50885,95295,759,380,1139
"2023","7",중국센트럴항공,59,59,118,0,0,0,691,226,917
"2023","7",중국우정항공,22,22,44,0,0,0,118,112,230
"2023","7",중국화물항공,24,24,48,0,0,0,1832,1136,2968
"2023","7",중화항공,93,93,186,16828,20766,37594,567,615,1182
"2023","7",진에어,948,949,1897,194456,201710,396166,319,441,760
"2023","7",집에어,31,31,62,7859,6718,14577,214,341,555
"2023","7",천진항공,31,31,62,3831,3851,7682,0,0,0
"2023","7",청도항공,29,29,58,1990,2446,4436,6,4,10
"2023","7",춘추항공,17,17,34,2716,2565,5281,7,4,11
"2023","7",카고룩스 이탈리아 항공,14,14,28,0,0,0,554,413,967
"2023","7",카고룩스항공,14,14,28,0,0,0,561,1114,1674
"2023","7",카타르항공,49,49,98,12577,11856,24433,1224,1799,3023
"2023","7",칼리타항공,36,37,73,0,0,0,1022,102,1124
"2023","7",캐세이퍼시픽항공,118,118,236,31432,31600,63032,1418,382,1800
"2023","7",콴타스항공,13,13,26,2446,3797,6243,14,58,72
"2023","7",타이거에어 타이완,31,31,62,5341,4908,10249,3,30,33
"2023","7",타이에어아시아엑스,44,44,88,13477,14309,27786,250,125,374
"2023","7",타이항공,92,92,184,14793,18370,33163,806,366,1173
"2023","7",터키항공,58,58,116,16678,14750,31428,1131,1509,2640
"2023","7",투르크메니스탄,4,4,8,0,0,0,80,111,191
"2023","7",티웨이항공,900,899,1799,173797,180783,354580,417,412,829
"2023","7",폴라에어카고,129,131,260,0,0,0,3881,4977,8858
"2023","7",폴란드항공,41,41,82,11381,10290,21671,231,371,602
"2023","7",피치항공,124,123,247,21319,20628,41947,0,10,10
"2023","7",핀에어,31,31,62,10291,9444,19735,492,474,966
"2023","7",필리핀에어아시아,80,80,160,10847,12104,22951,5,24,29
"2023","7",필리핀항공,155,155,310,24714,29639,54353,38,124,163
"2023","7",하와이안 항공,23,23,46,5998,6356,12354,156,325,481
"2023","7",홍콩익스프레스,55,55,110,11399,11168,22567,6,10,17
"2023","7",홍콩항공,18,18,36,2842,2698,5540,5,0,5
"2023","7",FedEX항공,131,129,260,0,0,0,3089,2735,5824
"2023","7",HFM,1,1,2,81,79,160,0,0,0
"2023","7",KLM네덜란드항공,61,61,122,5513,5663,11176,163,212,376
"2023","8",가루다인도네시아,25,25,50,5506,4242,9748,45,142,187
"2023","8",그레이터베이항공,18,18,36,2420,2206,4626,18,10,29
"2023","8",대한항공,3537,3525,7062,628894,605015,1233909,50501,50505,101006
"2023","8",델타항공,123,123,246,29244,36249,65493,113,773,886
"2023","8",디에이치엘항공,16,16,32,0,0,0,281,0,281
"2023","8",라오항공,22,22,44,2670,2632,5302,2,3,5
"2023","8",로얄브루나이항공,14,14,28,1091,1006,2097,0,2,2
"2023","8",루프트한자 독일항공,95,95,190,17851,19021,36872,842,1450,2292
"2023","8",말레이시아 항공,28,28,56,5952,4891,10843,227,279,506
"2023","8",몽골항공,99,98,197,18020,16642,34662,18,141,159
"2023","8",미얀마국제항공,13,13,26,1370,1119,2489,12,2,14
"2023","8",미얀마항공,8,8,16,1166,5,1171,2,4,7
"2023","8",바틱 에어 말레이시아,31,31,62,4177,3612,7789,0,0,0
"2023","8",뱀부 항공,29,29,58,5238,4638,9876,8,11,20
"2023","8",베트남항공,186,186,372,44638,37372,82010,964,907,1871
"2023","8",비엣젯항공,486,484,970,107319,91786,199105,550,116,667
"2023","8",사우디아항공,18,19,37,3964,5624,9588,30,143,173
"2023","8",사천항공,13,13,26,1754,1578,3332,0,4,4
"2023","8",산동항공,194,194,388,26282,22233,48515,38,5,43
"2023","8",상하이항공,30,30,60,4345,3926,8271,3,1,4
"2023","8",샤먼항공,30,30,60,4796,4838,9634,29,17,46
"2023","8",세부퍼시픽항공,102,103,205,17641,14175,31816,9,35,43
"2023","8",스리랑카항공,9,9,18,2104,1618,3722,44,91,136
"2023","8",스카이 앙코르 항공,16,16,32,2636,1927,4563,0,1,2
"2023","8",스쿠트 항공,40,40,80,13373,12226,25599,78,92,170
"2023","8",실크웨이웨스트항공,11,11,22,0,0,0,465,893,1359
"2023","8",심천항공,51,51,102,5477,5459,10936,131,6,137
"2023","8",싱가포르항공,146,145,291,31431,28710,60141,1130,1425,2555
"2023","8",아메리제트,12,12,24,0,0,0,73,330,403
"2023","8",아메리칸항공,31,31,62,7213,8796,16009,112,227,339
"2023","8",아시아나항공,2097,2096,4193,418771,401060,819831,22846,23671,46517
"2023","8",아틀라스항공,181,198,379,0,0,0,2799,535,3333
"2023","8",안토노프항공,1,0,1,0,0,0,73,0,73
"2023","8",에미레이트항공,32,33,65,14347,15378,29725,275,506,782
"2023","8",에바항공,80,80,160,18415,17967,36382,467,450,916
"2023","8",에어 뉴질랜드,10,11,21,1940,1839,3779,32,141,173
"2023","8",에어 아스타나,26,26,52,5370,5160,10530,5,74,79
"2023","8",에어 프랑스,31,31,62,9876,10060,19936,393,339,732
"2023","8",에어로 몽골리아,14,14,28,1737,1175,2912,0,0,0
"2023","8",에어로로직,30,30,60,0,0,0,1298,164,1462
"2023","8",에어마카오,31,31,62,4462,4394,8856,17,12,29
"2023","8",에어부산,356,357,713,72462,68478,140940,0,2,2
"2023","8",에어서울,396,396,792,74864,71794,146658,54,11,64
"2023","8",에어아시아엑스,45,45,90,14247,12223,26470,298,349,646
"2023","8",에어인디아 리미티드,18,18,36,3856,2924,6780,60,205,265
"2023","8",에어인천,158,160,318,0,0,0,1677,1523,3200
"2023","8",에어캐나다,61,61,122,16359,18286,34645,579,708,1288
"2023","8",에어프레미아,126,125,251,35608,35836,71444,893,1055,1948
"2023","8",에어홍콩,27,27,54,0,0,0,958,1136,2093
"2023","8",에티오피아항공,56,57,113,4950,4609,9559,973,324,1296
"2023","8",에티하드 항공,31,31,62,9802,9876,19678,320,489,809
"2023","8",우즈베키스탄항공,32,32,64,7144,6879,14023,20,204,224
"2023","8",유나이티드항공,62,62,124,13068,16191,29259,242,941,1183
"2023","8",유피에스항공,117,120,237,0,0,0,1519,2554,4073
"2023","8",이스타항공,1,0,1,184,0,184,0,0,0
"2023","8",전일본공수,20,20,40,0,0,0,602,680,1283
"2023","8",제주항공,1663,1658,3321,268537,252136,520673,1020,1075,2095
"2023","8",젯스타,18,18,36,5577,5350,10927,4,123,127
"2023","8",중국국제항공,198,198,396,28649,25742,54391,38,56,94
"2023","8",중국남방항공,378,377,755,60934,59468,120402,426,158,584
"2023","8",중국동방항공,369,369,738,53567,51542,105109,691,360,1051
"2023","8",중국센트럴항공,82,82,164,0,0,0,844,351,1195
"2023","8",중국우정항공,19,19,38,0,0,0,102,98,200
"2023","8",중국화물항공,26,26,52,0,0,0,1870,1067,2937
"2023","8",중화항공,93,93,186,18933,19961,38894,604,486,1090
"2023","8",진에어,960,958,1918,204654,197337,401991,407,464,871
"2023","8",집에어,31,31,62,8543,6791,15334,226,322,548
"2023","8",천진항공,31,31,62,4271,4030,8301,0,2,2
"2023","8",청도항공,30,30,60,3712,2940,6652,14,4,18
"2023","8",춘추항공,18,18,36,2949,2681,5630,1,2,3
"2023","8",카고룩스 이탈리아 항공,8,8,16,0,0,0,259,235,493
"2023","8",카고룩스항공,13,13,26,0,0,0,346,904,1250
"2023","8",카타르항공,47,46,93,12076,12219,24295,1325,1761,3085
"2023","8",칼리타항공,38,38,76,0,0,0,980,77,1058
"2023","8",캐세이퍼시픽항공,117,117,234,29531,28644,58175,1353,460,1812
"2023","8",콴타스항공,14,14,28,3586,3395,6981,13,57,71
"2023","8",타이거에어 타이완,31,31,62,5384,4786,10170,1,21,22
"2023","8",타이에어아시아엑스,45,44,89,15059,14062,29121,150,141,291
"2023","8",타이항공,93,93,186,21990,19142,41132,699,461,1160
"2023","8",터키항공,57,56,113,16145,15603,31748,1116,1585,2701
"2023","8",투르크메니스탄,5,5,10,0,0,0,98,142,240
"2023","8",티웨이항공,913,910,1823,184080,177405,361485,494,383,878
"2023","8",폴라에어카고,139,138,277,0,0,0,4370,4641,9011
"2023","8",폴란드항공,40,41,81,10779,11348,22127,231,359,591
"2023","8",피치항공,112,113,225,19857,18922,38779,0,9,9
"2023","8",핀에어,31,31,62,9614,9860,19474,549,402,951
"2023","8",필리핀에어아시아,77,77,154,12211,10162,22373,6,21,27
"2023","8",필리핀항공,153,153,306,29753,26505,56258,88,268,356
"2023","8",하와이안 항공,21,21,42,5376,5751,11127,66,295,362
"2023","8",홍콩익스프레스,80,80,160,16843,16750,33593,10,8,18
"2023","8",홍콩항공,18,18,36,2644,2811,5455,7,0,7
"2023","8",FedEX항공,134,135,269,0,0,0,2949,2743,5692
"2023","8",KLM네덜란드항공,59,59,118,5148,4918,10066,135,237,372
"2023","9",가루다인도네시아,25,25,50,4150,4251,8401,71,174,245
"2023","9",그레이터베이항공,27,27,54,2376,2562,4938,32,14,46
"2023","9",대한항공,3415,3428,6843,556341,591950,1148291,50213,52504,102717
"2023","9",델타항공,119,121,240,27480,34902,62382,136,924,1060
"2023","9",디에이치엘항공,9,9,18,0,0,0,130,0,130
"2023","9",라오항공,23,23,46,2072,2565,4637,1,22,23
"2023","9",로얄브루나이항공,13,13,26,1028,1061,2089,0,1,2
"2023","9",루프트한자 독일항공,91,92,183,14396,15912,30308,1007,1758,2765
"2023","9",말레이시아 항공,29,29,58,4657,6050,10707,318,390,708
"2023","9",몽골항공,73,74,147,11217,11321,22538,19,171,190
"2023","9",미얀마국제항공,14,14,28,1325,1174,2499,15,2,17
"2023","9",미얀마항공,5,5,10,733,7,740,3,1,4
"2023","9",바틱 에어 말레이시아,30,30,60,3646,3686,7332,0,0,0
"2023","9",뱀부 항공,24,24,48,3307,3722,7029,20,14,33
"2023","9",베트남항공,185,185,370,33952,39896,73848,1019,821,1839
"2023","9",비엣젯항공,463,464,927,76108,75326,151434,629,180,810
"2023","9",사우디아항공,17,17,34,3062,4629,7691,12,149,162
"2023","9",사천항공,13,13,26,1658,1513,3171,0,6,6
"2023","9",산동항공,210,210,420,20657,19556,40213,49,7,56
"2023","9",상하이항공,30,30,60,3457,3385,6842,24,2,26
"2023","9",샤먼항공,30,30,60,4651,3922,8573,29,26,55
"2023","9",세부퍼시픽항공,99,98,197,12815,13366,26181,13,57,70
"2023","9",스리랑카항공,8,8,16,1781,1433,3214,60,91,151
"2023","9",스카이 앙코르 항공,16,16,32,1421,1624,3045,2,0,2
"2023","9",스쿠트 항공,38,38,76,11322,12208,23530,90,132,221
"2023","9",실크웨이웨스트항공,10,10,20,0,0,0,482,951,1432
"2023","9",심천항공,48,48,96,6206,5938,12144,113,12,126
"2023","9",싱가포르항공,142,142,284,31176,33088,64264,1375,1592,2967
"2023","9",아메리제트,13,13,26,0,0,0,112,420,531
"2023","9",아메리칸항공,30,30,60,7424,8449,15873,117,225,342
"2023","9",아시아나항공,2004,2002,4006,337577,366662,704239,23519,25293,48812
"2023","9",아틀라스항공,182,194,376,0,0,0,3048,941,3989
"2023","9",에미레이트항공,30,29,59,13637,14134,27771,250,356,605
"2023","9",에바항공,78,78,156,16100,18553,34653,497,616,1113
"2023","9",에어 뉴질랜드,11,11,22,2264,2400,4664,96,176,272
"2023","9",에어 아스타나,26,26,52,4760,4629,9389,10,104,114
"2023","9",에어 프랑스,30,30,60,8992,9671,18663,388,323,710
"2023","9",에어로 몽골리아,13,13,26,643,716,1359,0,0,0
"2023","9",에어로로직,30,29,59,0,0,0,1356,182,1538
"2023","9",에어마카오,32,32,64,4061,4421,8482,17,10,27
"2023","9",에어부산,347,347,694,61522,67513,129035,1,12,13
"2023","9",에어서울,329,330,659,57187,61954,119141,58,23,81
"2023","9",에어아시아엑스,43,43,86,10504,11264,21768,311,217,528
"2023","9",에어인디아 리미티드,12,12,24,2037,2074,4111,22,131,153
"2023","9",에어인천,137,135,272,0,0,0,1517,1429,2946
"2023","9",에어캐나다,60,60,120,17250,17499,34749,546,711,1257
"2023","9",에어프레미아,111,111,222,29206,32302,61508,893,927,1820
"2023","9",에어홍콩,24,24,48,0,0,0,1066,1039,2104
"2023","9",에티오피아항공,55,54,109,4300,4527,8827,828,414,1242
"2023","9",에티하드 항공,30,30,60,8844,9005,17849,298,423,721
"2023","9",우즈베키스탄항공,32,32,64,6612,5978,12590,22,321,343
"2023","9",원통화물항공,23,23,46,0,0,0,344,185,529
"2023","9",유나이티드항공,60,60,120,12344,15665,28009,292,960,1251
"2023","9",유피에스항공,115,117,232,0,0,0,1443,2536,3978
"2023","9",이스타항공,53,55,108,7855,10246,18101,0,0,0
"2023","9",전일본공수,24,24,48,0,0,0,592,994,1586
"2023","9",제주항공,1557,1553,3110,232246,241540,473786,1021,1113,2133
"2023","9",젯스타,15,15,30,4501,4270,8771,7,116,123
"2023","9",중국국제항공,220,220,440,31199,27399,58598,53,69,123
"2023","9",중국남방항공,403,403,806,56957,53263,110220,535,132,667
"2023","9",중국동방항공,431,428,859,47741,48034,95775,758,518,1276
"2023","9",중국센트럴항공,75,75,150,0,0,0,962,352,1314
"2023","9",중국우정항공,17,17,34,0,0,0,124,93,217
"2023","9",중국화물항공,18,18,36,0,0,0,1416,927,2343
"2023","9",중화항공,91,91,182,14690,18657,33347,525,535,1060
"2023","9",진에어,808,810,1618,165644,173496,339140,506,746,1252
"2023","9",집에어,30,30,60,7486,6737,14223,207,336,543
"2023","9",천진항공,22,22,44,2492,2337,4829,0,1,1
"2023","9",청도항공,26,26,52,2259,2330,4589,14,4,18
"2023","9",춘추항공,18,18,36,2923,2607,5530,0,3,3
"2023","9",카고룩스 이탈리아 항공,12,12,24,0,0,0,235,519,754
"2023","9",카고룩스항공,12,12,24,0,0,0,420,1109,1529
"2023","9",카타르항공,47,47,94,11377,11858,23235,1431,2220,3651
"2023","9",칼리타항공,40,39,79,0,0,0,932,120,1051
"2023","9",캐세이퍼시픽항공,111,111,222,21881,22750,44631,1435,453,1887
"2023","9",콴타스항공,13,13,26,3507,3379,6886,19,72,91
"2023","9",타이거에어 타이완,30,30,60,4652,4531,9183,1,36,37
"2023","9",타이에어아시아엑스,43,43,86,11508,13044,24552,171,237,408
"2023","9",타이항공,87,87,174,11279,14877,26156,830,465,1295
"2023","9",터키항공,56,57,113,16096,16326,32422,1136,1667,2803
"2023","9",투르크메니스탄,4,4,8,0,0,0,54,129,183
"2023","9",티웨이항공,897,900,1797,160954,169926,330880,606,612,1217
"2023","9",폴라에어카고,132,131,263,0,0,0,4328,4672,9000
"2023","9",폴란드항공,39,39,78,9707,10765,20472,219,386,605
"2023","9",피치항공,121,121,242,19427,19710,39137,0,10,10
"2023","9",핀에어,29,29,58,8241,8888,17129,490,441,931
"2023","9",필리핀에어아시아,65,65,130,7590,7880,15470,2,20,22
"2023","9",필리핀항공,142,142,284,18954,22988,41942,36,232,268
"2023","9",하와이안 항공,23,23,46,6045,6266,12311,54,334,388
"2023","9",홍콩익스프레스,74,74,148,11120,11984,23104,17,16,32
"2023","9",홍콩항공,16,16,32,1976,2368,4344,6,0,6
"2023","9",FedEX항공,127,126,253,0,0,0,2950,2546,5496
"2023","9",KLM네덜란드항공,52,52,104,4335,4713,9048,89,187,275
"2023","10",가루다인도네시아,27,27,54,5892,4835,10727,85,202,287
"2023","10",그레이터베이항공,31,31,62,4271,3873,8144,31,13,43
"2023","10",내셔널항공,1,1,2,0,0,0,0,98,98
"2023","10",대한항공,3586,3574,7160,657842,609599,1267441,52279,52544,104823
"2023","10",델타항공,123,124,247,32897,33405,66302,114,1131,1245
"2023","10",디에이치엘항공,9,9,18,0,0,0,119,0,119
"2023","10",라오항공,31,31,62,3863,3877,7740,1,26,27
"2023","10",로얄브루나이항공,13,13,26,1132,1013,2145,0,3,4
"2023","10",루프트한자 독일항공,99,98,197,19659,15873,35532,880,1684,2565
"2023","10",말레이시아 항공,32,32,64,7805,7025,14830,300,336,636
"2023","10",몽골항공,60,59,119,9681,7414,17095,56,154,210
"2023","10",미얀마국제항공,16,16,32,1356,1461,2817,10,3,13
"2023","10",미얀마항공,3,3,6,443,0,443,1,1,2
"2023","10",바틱 에어 말레이시아,31,31,62,4222,3650,7872,0,0,0
"2023","10",뱀부 항공,23,23,46,3742,3487,7229,14,13,26
"2023","10",베트남항공,199,199,398,47411,44209,91620,1260,776,2036
"2023","10",비엣젯항공,459,459,918,88930,71844,160774,641,206,847
"2023","10",사우디아항공,18,18,36,4615,3604,8219,33,184,217
"2023","10",사천항공,13,13,26,1425,1485,2910,0,4,4
"2023","10",산동항공,215,215,430,19762,21440,41202,78,7,85
"2023","10",상하이항공,24,24,48,2727,2945,5672,16,3,19
"2023","10",샤먼항공,31,31,62,4613,4435,9048,37,42,79
"2023","10",세부퍼시픽항공,103,103,206,17955,14228,32183,13,69,81
"2023","10",스리랑카항공,9,9,18,1968,1461,3429,70,103,173
"2023","10",스카이 앙코르 항공,17,17,34,2391,2082,4473,0,1,1
"2023","10",스쿠트 항공,39,38,77,13369,11807,25176,52,129,181
"2023","10",실크웨이웨스트항공,9,9,18,0,0,0,499,989,1488
"2023","10",심천항공,53,53,106,6252,6353,12605,94,6,100
"2023","10",싱가포르항공,138,139,277,38472,36689,75161,1268,1475,2743
"2023","10",아메리제트,12,12,24,0,0,0,55,330,385
"2023","10",아메리칸항공,31,31,62,8486,8637,17123,86,285,371
"2023","10",아시아나항공,2072,2065,4137,407146,370942,778088,25063,25547,50611
"2023","10",아틀라스항공,188,189,377,0,0,0,2595,614,3208
"2023","10",안토노프항공,0,1,1,0,0,0,0,42,42
"2023","10",에미레이트항공,31,32,63,15226,15782,31008,229,412,641
"2023","10",에바항공,80,80,160,21924,20275,42199,522,528,1051
"2023","10",에어 뉴질랜드,11,11,22,2262,2885,5147,65,163,228
"2023","10",에어 아스타나,27,27,54,5157,4142,9299,10,127,138
"2023","10",에어 프랑스,31,31,62,10118,9113,19231,390,329,718
"2023","10",에어로 몽골리아,13,13,26,1007,733,1740,0,0,0
"2023","10",에어로로직,30,31,61,0,0,0,1419,159,1578
"2023","10",에어마카오,31,31,62,4044,3840,7884,18,2,20
"2023","10",에어부산,359,358,717,70379,67318,137697,3,9,12
"2023","10",에어서울,378,375,753,71094,67287,138381,62,29,91
"2023","10",에어아시아엑스,45,45,90,14975,12322,27297,313,275,588
"2023","10",에어아틀란타,3,3,6,0,0,0,0,280,280
"2023","10",에어인디아 리미티드,16,16,32,3384,3439,6823,48,171,219
"2023","10",에어인천,126,127,253,0,0,0,1557,1393,2950
"2023","10",에어캐나다,61,61,122,18116,17901,36017,565,735,1300
"2023","10",에어프레미아,121,122,243,35158,33251,68409,750,1077,1827
"2023","10",에어홍콩,23,23,46,0,0,0,976,1030,2006
"2023","10",에티오피아항공,57,58,115,5154,4259,9413,1144,491,1635
"2023","10",에티하드 항공,31,31,62,9625,8341,17966,396,501,896
"2023","10",우즈베키스탄항공,31,31,62,6876,5070,11946,18,257,275
"2023","10",원통화물항공,37,37,74,0,0,0,657,318,975
"2023","10",유나이티드항공,59,59,118,15019,11893,26912,293,1002,1295
"2023","10",유피에스항공,108,109,217,0,0,0,1222,2201,3423
"2023","10",이스타항공,165,162,327,29443,26741,56184,0,0,0
"2023","10",전일본공수,25,25,50,0,0,0,558,942,1501
"2023","10",제주항공,1600,1594,3194,259609,242567,502176,970,1042,2011
"2023","10",젯스타,13,13,26,3786,3983,7769,13,86,98
"2023","10",중국국제항공,229,229,458,29811,29237,59048,43,88,131
"2023","10",중국남방항공,491,491,982,56633,52924,109557,531,145,676
"2023","10",중국동방항공,447,447,894,49293,51926,101219,991,483,1474
"2023","10",중국센트럴항공,75,75,150,0,0,0,998,368,1365
"2023","10",중국우정항공,26,26,52,0,0,0,166,143,309
"2023","10",중국화물항공,12,12,24,0,0,0,1058,671,1728
"2023","10",중화항공,94,94,188,22928,21529,44457,518,574,1092
"2023","10",진에어,882,876,1758,202231,188152,390383,625,750,1375
"2023","10",집에어,31,31,62,8401,6198,14599,211,276,486
"2023","10",천진항공,19,19,38,2186,2059,4245,0,1,1
"2023","10",천진화물항공,2,2,4,0,0,0,0,0,0
"2023","10",청도항공,29,29,58,2781,2820,5601,12,2,15
"2023","10",춘추항공,27,27,54,3492,3065,6557,6,7,13
"2023","10",카고룩스 이탈리아 항공,11,11,22,0,0,0,322,482,804
"2023","10",카고룩스항공,13,13,26,0,0,0,405,936,1341
"2023","10",카타르항공,45,46,91,11943,11744,23687,1290,1941,3232
"2023","10",칼리타항공,39,39,78,0,0,0,565,279,844
"2023","10",캐세이퍼시픽항공,117,117,234,30702,29019,59721,1436,420,1855
"2023","10",콴타스항공,14,13,27,3632,3743,7375,18,59,77
"2023","10",타이거에어 타이완,32,31,63,5443,4518,9961,1,33,35
"2023","10",타이에어아시아엑스,42,43,85,14069,12783,26852,179,221,400
"2023","10",타이항공,93,93,186,22605,19043,41648,825,505,1330
"2023","10",터키항공,57,56,113,16603,14154,30757,1005,1620,2625
"2023","10",투르크메니스탄,6,5,11,0,0,0,162,170,332
"2023","10",티웨이항공,951,947,1898,182195,170941,353136,765,593,1358
"2023","10",폴라에어카고,135,138,273,0,0,0,4458,4926,9384
"2023","10",폴란드항공,39,39,78,11062,9142,20204,295,446,741
"2023","10",피치항공,128,128,256,21890,20010,41900,0,9,9
"2023","10",핀에어,31,31,62,9320,7782,17102,553,468,1021
"2023","10",필리핀에어아시아,81,81,162,12045,8787,20832,4,21,25
"2023","10",필리핀항공,149,149,298,24907,21703,46610,28,279,307
"2023","10",하와이안 항공,23,23,46,6321,5874,12195,79,331,410
"2023","10",홍콩익스프레스,80,80,160,15272,14699,29971,21,23,44
"2023","10",홍콩항공,18,18,36,2631,2826,5457,14,5,19
"2023","10",FedEX항공,130,132,262,0,0,0,2665,2593,5258
"2023","10",KLM네덜란드항공,51,50,101,5316,4864,10180,132,163,295
"2023","10",MY FREIGHTER AIRLINES,1,1,2,0,0,0,0,83,83
"2023","11",가루다인도네시아,25,25,50,4877,5508,10385,89,296,385
"2023","11",그레이터베이항공,30,30,60,2588,3264,5852,42,11,54
"2023","11",대한항공,3804,3806,7610,639412,655885,1295297,52479,54683,107162
"2023","11",델타항공,115,118,233,28769,32331,61100,97,1131,1228
"2023","11",디에이치엘항공,10,10,20,0,0,0,149,0,149
"2023","11",라오항공,30,30,60,3296,3742,7038,2,20,22
"2023","11",로얄브루나이항공,13,13,26,1213,1071,2284,0,5,5
"2023","11",루프트한자 독일항공,76,77,153,12284,13269,25553,486,1659,2145
"2023","11",말레이시아 항공,30,30,60,6793,7668,14461,319,459,778
"2023","11",몽골항공,51,52,103,6707,7065,13772,30,196,226
"2023","11",미얀마국제항공,16,16,32,1393,1443,2836,13,7,20
"2023","11",미얀마항공,2,2,4,301,2,303,0,1,2
"2023","11",바틱 에어 말레이시아,17,17,34,2317,2162,4479,0,0,0
"2023","11",베트남항공,184,184,368,39663,43863,83526,1144,872,2016
"2023","11",비엣젯항공,454,454,908,81705,88278,169983,607,251,858
"2023","11",사우디아항공,17,17,34,2095,2098,4193,17,240,257
"2023","11",사천항공,13,13,26,1575,1640,3215,0,8,8
"2023","11",산동항공,224,224,448,20581,20886,41467,218,7,225
"2023","11",상하이항공,19,19,38,1945,2308,4253,13,3,16
"2023","11",샤먼항공,30,30,60,4013,4188,8201,31,27,57
"2023","11",세부퍼시픽항공,90,90,180,15360,15903,31263,13,105,118
"2023","11",스리랑카항공,8,8,16,898,1279,2177,74,106,180
"2023","11",스카이 앙코르 항공,16,16,32,2110,2636,4746,0,2,2
"2023","11",스쿠트 항공,30,31,61,10088,10589,20677,57,173,231
"2023","11",실크웨이웨스트항공,8,8,16,0,0,0,673,994,1667
"2023","11",심천항공,48,48,96,4955,5130,10085,108,15,124
"2023","11",싱가포르항공,133,133,266,35743,36089,71832,1175,1441,2616
"2023","11",아메리제트,37,37,74,0,0,0,184,358,542
"2023","11",아메리칸항공,30,30,60,7040,8407,15447,71,256,327
"2023","11",아시아나항공,2033,2033,4066,364130,376339,740469,23953,26903,50856
"2023","11",아틀라스항공,184,189,373,0,0,0,2562,568,3130
"2023","11",안토노프항공,2,0,2,0,0,0,39,0,39
"2023","11",에미레이트항공,30,30,60,13192,13892,27084,245,395,639
"2023","11",에바항공,77,77,154,18360,18548,36908,367,408,776
"2023","11",에어 뉴질랜드,13,13,26,2843,3171,6014,32,209,241
"2023","11",에어 아스타나,29,29,58,4189,4256,8445,8,47,54
"2023","11",에어 프랑스,30,30,60,9582,9567,19149,405,335,739
"2023","11",에어로 몽골리아,13,13,26,503,581,1084,0,0,0
"2023","11",에어로로직,42,42,84,0,0,0,1695,542,2237
"2023","11",에어마카오,30,30,60,3591,4057,7648,16,6,22
"2023","11",에어부산,348,348,696,65519,67668,133187,0,2,2
"2023","11",에어서울,373,374,747,69430,70980,140410,58,32,90
"2023","11",에어아시아엑스,51,51,102,15173,15752,30925,361,392,754
"2023","11",에어인디아 리미티드,17,17,34,3474,3748,7222,64,200,265
"2023","11",에어인천,151,151,302,0,0,0,2021,1614,3635
"2023","11",에어캐나다,56,56,112,16624,16547,33171,465,757,1222
"2023","11",에어프레미아,115,114,229,30837,31590,62427,629,1198,1827
"2023","11",에어홍콩,26,26,52,0,0,0,1066,1185,2251
"2023","11",에티오피아항공,64,63,127,4499,4742,9241,1162,624,1786
"2023","11",에티하드 항공,30,30,60,6775,5976,12751,290,437,727
"2023","11",우즈베키스탄항공,33,33,66,4820,4935,9755,28,431,459
"2023","11",원통화물항공,45,45,90,0,0,0,938,383,1321
"2023","11",유나이티드항공,30,30,60,6612,6856,13468,207,582,789
"2023","11",유피에스항공,117,118,235,0,0,0,1250,2617,3867
"2023","11",이스타항공,255,255,510,44473,44437,88910,0,0,0
"2023","11",일본항공,1,1,2,0,124,124,0,0,0
"2023","11",전일본공수,26,26,52,0,0,0,559,1020,1579
"2023","11",제주항공,1452,1449,2901,217655,224740,442395,1146,1199,2345
"2023","11",젯스타,13,13,26,3996,3902,7898,10,112,122
"2023","11",중국국제항공,185,185,370,20444,20384,40828,83,68,151
"2023","11",중국남방항공,380,380,760,37763,38934,76697,505,139,644
"2023","11",중국동방항공,437,438,875,48814,48746,97560,734,444,1177
"2023","11",중국센트럴항공,100,100,200,0,0,0,1521,432,1953
"2023","11",중국우정항공,30,30,60,0,0,0,228,151,379
"2023","11",중국화물항공,13,13,26,0,0,0,1126,826,1952
"2023","11",중화항공,90,90,180,21687,22817,44504,565,600,1166
"2023","11",진에어,743,745,1488,165609,168144,333753,601,1092,1693
"2023","11",집에어,30,30,60,7071,6221,13292,211,320,531
"2023","11",천진항공,15,15,30,1368,1421,2789,0,0,1
"2023","11",천진화물항공,18,18,36,0,0,0,25,1,26
"2023","11",청도항공,22,22,44,1430,1959,3389,1,3,5
"2023","11",춘추항공,26,26,52,3369,3191,6560,6,2,8
"2023","11",카고룩스 이탈리아 항공,13,13,26,0,0,0,495,572,1067
"2023","11",카고룩스항공,13,13,26,0,0,0,280,960,1240
"2023","11",카타르항공,47,47,94,10337,11176,21513,1336,2230,3566
"2023","11",칼리타항공,72,73,145,0,0,0,1138,1548,2686
"2023","11",캐세이퍼시픽항공,132,132,264,27025,28614,55639,1579,477,2056
"2023","11",콴타스항공,17,18,35,4320,4429,8749,22,147,169
"2023","11",타이거에어 타이완,30,30,60,5101,4936,10037,2,37,38
"2023","11",타이에어아시아엑스,39,39,78,11936,13577,25513,241,239,479
"2023","11",타이항공,90,90,180,18409,24870,43279,871,625,1496
"2023","11",터키항공,55,55,110,14269,12693,26962,1025,1506,2531
"2023","11",투르크메니스탄,4,5,9,0,0,0,174,226,400
"2023","11",티웨이항공,864,863,1727,159339,160548,319887,624,718,1342
"2023","11",폴라에어카고,124,123,247,0,0,0,3074,3046,6119
"2023","11",폴란드항공,30,30,60,6004,6210,12214,202,343,545
"2023","11",피치항공,148,148,296,25921,25275,51196,0,11,11
"2023","11",핀에어,30,30,60,6414,6689,13103,572,515,1087
"2023","11",필리핀에어아시아,90,90,180,12459,13904,26363,2,26,28
"2023","11",필리핀항공,106,106,212,15548,20418,35966,27,252,279
"2023","11",하와이안 항공,21,21,42,5075,5554,10629,56,367,423
"2023","11",홍콩익스프레스,78,78,156,12685,12691,25376,15,42,56
"2023","11",홍콩항공,17,17,34,3304,4108,7412,149,144,293
"2023","11",ABD,2,2,4,0,0,0,0,190,190
"2023","11",FedEX항공,130,130,260,0,0,0,2713,2846,5560
"2023","11",KLM네덜란드항공,24,24,48,6661,6606,13267,279,266,546
"2023","11",MJ,1,0,1,0,0,0,0,0,0
"2023","11",MY FREIGHTER AIRLINES,2,2,4,0,0,0,0,92,92
"2023","11",RON,1,1,2,8,0,8,0,0,0
"2023","12",가루다인도네시아,37,37,74,7858,7198,15056,98,270,368
"2023","12",그레이터베이항공,31,31,62,3226,3630,6856,35,19,54
"2023","12",대한항공,3973,3967,7940,693576,686510,1380086,53016,54137,107153
"2023","12",델타항공,124,125,249,31438,33156,64594,150,1198,1348
"2023","12",디에이치엘항공,13,13,26,0,0,0,275,0,275
"2023","12",라오항공,31,31,62,3455,3569,7024,1,8,9
"2023","12",로얄브루나이항공,13,13,26,1662,1501,3163,0,2,2
"2023","12",루프트한자 독일항공,71,70,141,11382,10646,22028,709,1238,1947
"2023","12",말레이시아 항공,31,31,62,6965,7844,14809,306,429,735
"2023","12",몽골항공,53,52,105,7084,6765,13849,27,239,266
"2023","12",미얀마국제항공,16,16,32,1608,1538,3146,9,5,13
"2023","12",미얀마항공,6,6,12,906,25,931,3,3,6
"2023","12",바틱 에어 말레이시아,25,25,50,3558,3779,7337,0,0,0
"2023","12",베트남항공,186,186,372,41339,44071,85410,1014,699,1713
"2023","12",북경수도항공,6,6,12,176,615,791,0,0,0
"2023","12",비엣젯항공,484,483,967,88856,89261,178117,455,223,678
"2023","12",사우디아항공,17,17,34,1323,1738,3061,20,254,274
"2023","12",사천항공,13,13,26,1395,1620,3015,0,5,5
"2023","12",산동항공,242,242,484,23252,28001,51253,220,8,229
"2023","12",상하이항공,25,25,50,2787,3523,6310,18,5,24
"2023","12",샤먼항공,31,31,62,4599,4855,9454,36,21,56
"2023","12",세부퍼시픽항공,93,93,186,16899,17649,34548,18,95,113
"2023","12",스리랑카항공,10,10,20,1757,1645,3402,58,125,183
"2023","12",스카이 앙코르 항공,27,27,54,3164,4219,7383,0,2,2
"2023","12",스쿠트 항공,31,31,62,10940,10977,21917,96,124,219
"2023","12",실크웨이웨스트항공,11,11,22,0,0,0,577,1115,1693
"2023","12",심천항공,53,53,106,6013,6170,12183,104,13,116
"2023","12",싱가포르항공,149,149,298,37111,38226,75337,1362,1600,2962
"2023","12",아메리제트,31,31,62,0,0,0,213,315,528
"2023","12",아메리칸항공,31,31,62,8249,8555,16804,63,293,356
"2023","12",아시아나항공,2167,2170,4337,407568,412381,819949,25274,26309,51583
"2023","12",아틀라스항공,170,179,349,0,0,0,3205,530,3735
"2023","12",에미레이트항공,31,30,61,11263,13207,24470,403,422,826
"2023","12",에바항공,80,80,160,19081,19232,38313,456,450,906
"2023","12",에어 뉴질랜드,13,13,26,3322,3240,6562,42,189,231
"2023","12",에어 아스타나,28,28,56,3519,4053,7572,11,96,107
"2023","12",에어 프랑스,30,30,60,9417,8661,18078,415,429,845
"2023","12",에어로 몽골리아,12,12,24,784,585,1369,0,0,0
"2023","12",에어로로직,41,41,82,0,0,0,1669,514,2183
"2023","12",에어로케이항공,1,0,1,157,0,157,0,0,0
"2023","12",에어마카오,40,40,80,4445,4649,9094,25,3,29
"2023","12",에어부산,359,359,718,69505,70858,140363,0,2,2
"2023","12",에어서울,396,398,794,74134,75598,149732,50,40,90
"2023","12",에어아시아엑스,54,54,108,16445,15579,32024,291,456,747
"2023","12",에어인디아 리미티드,18,18,36,3954,3973,7927,75,164,239
"2023","12",에어인천,144,143,287,0,0,0,1917,1476,3394
"2023","12",에어캐나다,61,61,122,17774,17660,35434,491,754,1245
"2023","12",에어프레미아,111,113,224,30380,31503,61883,523,1014,1537
"2023","12",에어홍콩,25,25,50,0,0,0,1045,1160,2205
"2023","12",에티오피아항공,61,62,123,4327,3672,7999,982,368,1351
"2023","12",에티하드 항공,31,31,62,5934,6435,12369,290,421,712
"2023","12",우즈베키스탄항공,34,34,68,4913,6186,11099,37,375,412
"2023","12",원통화물항공,46,46,92,0,0,0,1097,329,1426
"2023","12",유나이티드항공,31,31,62,7302,6633,13935,193,644,837
"2023","12",유피에스항공,118,116,234,0,0,0,1348,2465,3813
"2023","12",이스타항공,320,315,635,54567,54936,109503,0,0,0
"2023","12",전일본공수,27,27,54,0,0,0,508,1032,1540
"2023","12",제주항공,1651,1640,3291,257853,264403,522256,1329,1264,2593
"2023","12",젯스타,14,13,27,4311,3486,7797,29,99,128
"2023","12",중국국제항공,194,194,388,19982,21989,41971,72,70,142
"2023","12",중국남방항공,495,495,990,46399,59026,105425,523,152,675
"2023","12",중국동방항공,492,491,983,48184,54040,102224,803,458,1260
"2023","12",중국센트럴항공,78,78,156,0,0,0,1138,395,1533
"2023","12",중국우정항공,23,23,46,0,0,0,226,138,364
"2023","12",중국화물항공,12,12,24,0,0,0,1050,741,1790
"2023","12",중화항공,93,93,186,21088,21940,43028,588,647,1235
"2023","12",진에어,917,917,1834,198870,206663,405533,668,988,1656
"2023","12",집에어,31,31,62,6741,6025,12766,218,305,523
"2023","12",천진항공,23,23,46,2145,2488,4633,0,2,2
"2023","12",천진화물항공,9,9,18,0,0,0,29,2,31
"2023","12",청도항공,53,53,106,3684,6065,9749,40,4,44
"2023","12",춘추항공,27,27,54,3601,4102,7703,4,7,11
"2023","12",카고룩스 이탈리아 항공,11,11,22,0,0,0,695,450,1145
"2023","12",카고룩스항공,13,13,26,0,0,0,337,972,1309
"2023","12",카타르항공,49,49,98,8720,10163,18883,1743,2061,3804
"2023","12",칼리타항공,67,66,133,0,0,0,1246,1553,2799
"2023","12",캐세이퍼시픽항공,119,120,239,26140,26817,52957,1540,596,2137
"2023","12",콴타스항공,16,16,32,4362,3577,7939,43,132,174
"2023","12",타이거에어 타이완,31,31,62,5083,4662,9745,1,33,35
"2023","12",타이에어아시아엑스,62,62,124,18037,20058,38095,143,287,430
"2023","12",타이항공,93,93,186,23307,26236,49543,851,454,1304
"2023","12",터키항공,59,59,118,12748,11591,24339,1337,1690,3026
"2023","12",투르크메니스탄,4,4,8,0,0,0,128,130,258
"2023","12",티웨이항공,920,918,1838,176224,178698,354922,705,787,1492
"2023","12",폴라에어카고,98,98,196,0,0,0,2896,2784,5680
"2023","12",폴란드항공,30,30,60,6210,5562,11772,193,291,484
"2023","12",피치항공,155,155,310,27387,26110,53497,0,8,8
"2023","12",핀에어,30,30,60,5827,5437,11264,669,450,1119
"2023","12",필리핀에어아시아,93,93,186,13480,14731,28211,7,30,38
"2023","12",필리핀항공,155,154,309,29052,33305,62357,33,334,367
"2023","12",하와이안 항공,23,23,46,5983,5732,11715,31,368,398
"2023","12",홍콩익스프레스,79,79,158,13647,12707,26354,22,28,50
"2023","12",홍콩항공,24,24,48,5434,5520,10954,184,154,338
"2023","12",ABD,1,1,2,0,0,0,0,97,97
"2023","12",FedEX항공,150,149,299,0,0,0,3265,3253,6518
"2023","12",KLM네덜란드항공,26,26,52,7249,7395,14644,279,309,588
"2023","12",MY FREIGHTER AIRLINES,1,1,2,0,0,0,0,44,44
"2023","12",RON,1,1,2,1,0,1,0,0,0
"2024","1",가루다인도네시아,36,36,72,6111,7218,13329,92,228,320
"2024","1",그레이터베이항공,31,31,62,3853,5046,8899,34,18,52
"2024","1",대한항공,3990,3995,7985,675884,709863,1385747,51064,52278,103341
"2024","1",델타항공,124,125,249,29404,34145,63549,109,979,1089
"2024","1",디에이치엘항공,2,2,4,0,0,0,8,0,8
"2024","1",라오항공,31,31,62,3607,3697,7304,1,6,7
"2024","1",로얄브루나이항공,14,14,28,1277,1581,2858,0,1,1
"2024","1",로얄에어필리핀,21,20,41,1283,1393,2676,0,0,0
"2024","1",루프트한자 독일항공,72,71,143,12935,15110,28045,538,1057,1596
"2024","1",말레이시아 항공,31,31,62,5782,7904,13686,317,353,670
"2024","1",몽골항공,49,50,99,6817,8037,14854,24,138,162
"2024","1",미얀마국제항공,15,15,30,1526,1440,2966,4,1,5
"2024","1",미얀마항공,6,6,12,912,78,990,2,2,3
"2024","1",바틱 에어 말레이시아,31,31,62,4157,5218,9375,0,3,3
"2024","1",베트남항공,186,186,372,41414,46723,88137,1106,832,1938
"2024","1",북경수도항공,1,1,2,19,99,118,0,0,0
"2024","1",비엣젯항공,482,485,967,91087,91792,182879,646,224,870
"2024","1",사우디아항공,19,19,38,2086,2322,4408,14,231,245
"2024","1",사천항공,17,17,34,1859,2035,3894,0,9,9
"2024","1",산동항공,269,268,537,23152,25933,49085,170,5,176
"2024","1",상하이항공,31,31,62,3761,4658,8419,16,0,16
"2024","1",샤먼항공,32,32,64,4389,4977,9366,33,16,49
"2024","1",세부퍼시픽항공,87,87,174,16963,16791,33754,13,81,95
"2024","1",스리랑카항공,13,13,26,2449,2390,4839,133,135,268
"2024","1",스카이 앙코르 항공,62,62,124,9930,10404,20334,0,5,5
"2024","1",스쿠트 항공,31,31,62,9566,11014,20580,72,177,250
"2024","1",실크웨이웨스트항공,10,10,20,0,0,0,569,989,1558
"2024","1",심천항공,53,53,106,6129,6623,12752,93,16,109
"2024","1",싱가포르항공,147,147,294,26746,35211,61957,1389,1650,3038
"2024","1",아메리제트,14,14,28,0,0,0,1,319,320
"2024","1",아메리칸항공,31,31,62,7290,8356,15646,62,285,346
"2024","1",아시아나항공,2263,2260,4523,425295,453361,878656,22464,21327,43791
"2024","1",아틀라스항공,152,157,309,0,0,0,2246,415,2661
"2024","1",에미레이트항공,31,31,62,12769,13738,26507,363,425,787
"2024","1",에바항공,79,79,158,19993,19351,39344,474,441,915
"2024","1",에어 뉴질랜드,12,12,24,2613,3395,6008,51,115,166
"2024","1",에어 아스타나,28,28,56,3712,3833,7545,3,12,15
"2024","1",에어 프랑스,29,29,58,9182,9561,18743,413,357,770
"2024","1",에어로 몽골리아,14,14,28,1375,1261,2636,0,0,0
"2024","1",에어로로직,39,39,78,0,0,0,1536,467,2003
"2024","1",에어마카오,38,38,76,4514,4645,9159,35,7,43
"2024","1",에어부산,358,358,716,71285,74892,146177,0,3,3
"2024","1",에어서울,421,420,841,75557,80662,156219,54,27,81
"2024","1",에어아시아엑스,53,53,106,15049,17716,32765,291,401,692
"2024","1",에어인디아 리미티드,17,17,34,3783,3702,7485,65,174,239
"2024","1",에어인천,136,137,273,0,0,0,1776,1378,3154
"2024","1",에어캐나다,63,62,125,18025,18212,36237,535,738,1273
"2024","1",에어프레미아,123,122,245,32236,36071,68307,513,910,1423
"2024","1",에어홍콩,26,26,52,0,0,0,1018,1203,2221
"2024","1",에티오피아항공,65,64,129,4376,4785,9161,1038,308,1346
"2024","1",에티하드 항공,31,31,62,7607,7669,15276,293,411,704
"2024","1",우즈베키스탄항공,30,30,60,5485,5643,11128,25,158,184
"2024","1",원통화물항공,54,54,108,0,0,0,1071,256,1327
"2024","1",유나이티드항공,31,31,62,6293,7370,13663,192,549,740
"2024","1",유피에스항공,112,114,226,0,0,0,1173,2103,3276
"2024","1",이스타항공,320,318,638,51914,55045,106959,0,0,0
"2024","1",전일본공수,21,21,42,0,0,0,516,756,1272
"2024","1",제주항공,1741,1741,3482,262980,275228,538208,1586,1368,2954
"2024","1",젯스타,13,14,27,3595,4350,7945,20,80,100
"2024","1",중국국제항공,195,195,390,21167,21764,42931,87,65,152
"2024","1",중국남방항공,536,536,1072,53055,61859,114914,520,161,681
"2024","1",중국동방항공,528,528,1056,51935,56788,108723,724,458,1182
"2024","1",중국센트럴항공,65,65,130,0,0,0,761,257,1018
"2024","1",중국우정항공,26,26,52,0,0,0,265,153,418
"2024","1",중국화물항공,10,10,20,0,0,0,874,516,1391
"2024","1",중화항공,93,93,186,23381,23103,46484,625,596,1221
"2024","1",진에어,979,980,1959,214809,222402,437211,796,801,1597
"2024","1",집에어,31,31,62,6385,6743,13128,207,272,479
"2024","1",천진항공,31,31,62,2719,2862,5581,0,6,6
"2024","1",천진화물항공,20,20,40,0,0,0,124,16,140
"2024","1",청도항공,39,39,78,1797,3126,4923,18,4,22
"2024","1",춘추항공,28,28,56,4268,4069,8337,1,3,4
"2024","1",카고룩스 이탈리아 항공,14,14,28,0,0,0,648,624,1272
"2024","1",카고룩스항공,12,12,24,0,0,0,345,837,1182
"2024","1",카타르항공,47,47,94,9296,11616,20912,1363,1678,3041
"2024","1",칼리타항공,50,51,101,0,0,0,675,1548,2223
"2024","1",캐세이퍼시픽항공,109,108,217,24223,26068,50291,1233,435,1668
"2024","1",콴타스항공,18,18,36,3715,4836,8551,30,105,135
"2024","1",타이거에어 타이완,31,31,62,5353,4604,9957,2,26,28
"2024","1",타이에어아시아엑스,62,62,124,20380,21462,41842,210,291,500
"2024","1",타이항공,93,93,186,22787,26181,48968,941,296,1236
"2024","1",터키항공,57,57,114,14025,14126,28151,1123,1474,2598
"2024","1",투르크메니스탄,4,4,8,0,0,0,97,134,231
"2024","1",티웨이항공,997,998,1995,189874,198462,388336,663,522,1185
"2024","1",폴라에어카고,79,80,159,0,0,0,2899,1860,4759
"2024","1",폴란드항공,27,27,54,5337,6100,11437,188,203,390
"2024","1",피치항공,155,155,310,26651,26889,53540,0,8,8
"2024","1",핀에어,31,30,61,6184,7016,13200,627,434,1062
"2024","1",필리핀에어아시아,93,93,186,14365,14911,29276,2,22,25
"2024","1",필리핀항공,155,156,311,30222,32363,62585,23,311,334
"2024","1",하와이안 항공,22,22,44,4793,5410,10203,23,303,326
"2024","1",홍콩익스프레스,80,80,160,14082,14962,29044,26,22,48
"2024","1",홍콩항공,31,31,62,6784,7808,14592,335,137,472
"2024","1",FedEX항공,149,150,299,0,0,0,2683,2514,5197
"2024","1",KLM네덜란드항공,26,27,53,7390,8028,15418,315,303,617
"2024","2",가루다인도네시아,33,33,66,6498,5964,12462,72,257,329
"2024","2",그레이터베이항공,33,33,66,4009,4975,8984,24,12,36
"2024","2",내셔널항공,1,1,2,0,0,0,0,100,100
"2024","2",대한항공,3804,3792,7596,700416,665476,1365892,49935,48643,98578
"2024","2",델타항공,115,118,233,28392,27430,55822,102,951,1052
"2024","2",라오항공,29,28,57,2824,2930,5754,1,6,7
"2024","2",로얄브루나이항공,12,12,24,1550,1426,2976,1,2,4
"2024","2",로얄에어필리핀,3,3,6,108,1,109,0,0,0
"2024","2",롱하오항공,9,9,18,0,0,0,93,53,146
"2024","2",루프트한자 독일항공,62,63,125,12670,10477,23147,772,1037,1808
"2024","2",말레이시아 항공,30,30,60,7690,6531,14221,337,420,756
"2024","2",몽골항공,45,45,90,6379,7148,13527,22,142,164
"2024","2",미얀마국제항공,17,17,34,1800,1425,3225,3,3,6
"2024","2",미얀마항공,5,5,10,744,48,792,2,1,3
"2024","2",바틱 에어 말레이시아,29,29,58,4827,4289,9116,0,3,3
"2024","2",베트남항공,174,174,348,40703,40297,81000,868,620,1488
"2024","2",북경수도항공,6,6,12,413,735,1148,0,0,0
"2024","2",비엣젯항공,455,453,908,87998,80814,168812,263,118,381
"2024","2",사우디아항공,12,12,24,1659,1149,2808,21,170,191
"2024","2",사천항공,20,20,40,2658,2721,5379,0,12,12
"2024","2",산동항공,257,257,514,33376,32700,66076,257,9,266
"2024","2",상하이항공,29,29,58,4129,4230,8359,24,2,27
"2024","2",샤먼항공,55,55,110,6043,5964,12007,18,9,27
"2024","2",세부퍼시픽항공,87,87,174,18675,16518,35193,62,152,214
"2024","2",스리랑카항공,9,9,18,2101,1410,3511,100,98,198
"2024","2",스카이 앙코르 항공,58,58,116,9711,8832,18543,0,2,2
"2024","2",스쿠트 항공,28,28,56,9471,9436,18907,71,116,187
"2024","2",실크웨이웨스트항공,13,12,25,0,0,0,785,1168,1953
"2024","2",심천항공,49,49,98,5820,6037,11857,65,5,70
"2024","2",싱가포르항공,139,139,278,31383,28346,59729,1472,1599,3071
"2024","2",아메리제트,11,11,22,0,0,0,23,348,371
"2024","2",아메리칸항공,29,29,58,7604,7040,14644,64,311,375
"2024","2",아시아나항공,2094,2084,4178,439494,417063,856557,20778,19915,40693
"2024","2",아틀라스항공,116,132,248,0,0,0,2213,234,2447
"2024","2",에미레이트항공,34,34,68,12998,13284,26282,335,493,828
"2024","2",에바항공,75,75,150,17946,18849,36795,460,353,813
"2024","2",에어 뉴질랜드,13,13,26,2992,3336,6328,26,77,104
"2024","2",에어 아스타나,21,21,42,3606,3228,6834,7,68,75
"2024","2",에어 프랑스,24,24,48,8253,5956,14209,385,342,727
"2024","2",에어로 몽골리아,12,12,24,1022,1031,2053,0,0,0
"2024","2",에어로로직,36,36,72,0,0,0,1649,506,2155
"2024","2",에어마카오,38,38,76,4258,4800,9058,15,5,21
"2024","2",에어부산,336,336,672,72543,71994,144537,20,2,22
"2024","2",에어서울,394,394,788,77727,77044,154771,40,19,59
"2024","2",에어아시아엑스,49,49,98,16554,13578,30132,328,327,655
"2024","2",에어인디아 리미티드,17,17,34,3958,3228,7186,37,176,213
"2024","2",에어인천,107,106,213,0,0,0,1333,1067,2400
"2024","2",에어재팬,5,5,10,1561,1513,3074,21,22,43
"2024","2",에어캐나다,58,58,116,17211,17004,34215,414,713,1128
"2024","2",에어프레미아,116,116,232,34516,33371,67887,793,1022,1815
"2024","2",에어홍콩,23,23,46,0,0,0,891,1011,1903
"2024","2",에티오피아항공,61,62,123,5698,4248,9946,1077,330,1406
"2024","2",에티하드 항공,29,29,58,8146,6192,14338,312,420,733
"2024","2",우즈베키스탄항공,29,29,58,6472,5568,12040,23,174,198
"2024","2",원통화물항공,34,34,68,0,0,0,774,199,974
"2024","2",유나이티드항공,29,29,58,6559,5823,12382,142,541,682
"2024","2",유피에스항공,100,102,202,0,0,0,1037,1970,3007
"2024","2",이스타항공,309,307,616,55602,54179,109781,0,0,0
"2024","2",일본항공,8,8,16,0,0,0,120,191,311
"2024","2",전일본공수,24,24,48,0,0,0,649,772,1421
"2024","2",제주항공,1652,1647,3299,269733,263843,533576,1275,966,2241
"2024","2",젯스타,29,29,58,8835,8956,17791,9,88,97
"2024","2",중국국제항공,194,194,388,27174,26520,53694,135,41,176
"2024","2",중국남방항공,468,468,936,64376,65718,130094,518,113,630
"2024","2",중국동방항공,524,524,1048,61951,65432,127383,660,367,1027
"2024","2",중국센트럴항공,27,27,54,0,0,0,296,112,408
"2024","2",중국우정항공,14,14,28,0,0,0,121,110,231
"2024","2",중국화물항공,7,7,14,0,0,0,611,410,1022
"2024","2",중화항공,88,88,176,21254,22850,44104,603,432,1035
"2024","2",진에어,918,917,1835,209390,206870,416260,871,634,1504
"2024","2",집에어,29,29,58,7670,6802,14472,204,196,400
"2024","2",천진항공,27,27,54,3111,3209,6320,0,7,7
"2024","2",천진화물항공,1,1,2,0,0,0,1,0,1
"2024","2",청도항공,27,27,54,3226,3683,6909,16,3,18
"2024","2",춘추항공,32,32,64,5150,4917,10067,3,3,6
"2024","2",카고룩스 이탈리아 항공,8,8,16,0,0,0,458,351,810
"2024","2",카고룩스항공,13,13,26,0,0,0,434,933,1368
"2024","2",카타르항공,45,44,89,10694,10314,21008,1631,1788,3419
"2024","2",칼리타항공,55,55,110,0,0,0,876,1857,2733
"2024","2",캐세이퍼시픽항공,120,120,240,26250,25527,51777,1383,498,1881
"2024","2",콴타스항공,17,17,34,3649,4454,8103,18,62,80
"2024","2",타이거에어 타이완,29,29,58,4792,4625,9417,1,14,15
"2024","2",타이에어아시아엑스,58,57,115,19759,18639,38398,457,239,697
"2024","2",타이항공,87,87,174,23401,21530,44931,1306,393,1699
"2024","2",터키항공,52,52,104,13579,10879,24458,1113,1335,2449
"2024","2",투르크메니스탄,3,3,6,0,0,0,142,119,260
"2024","2",티웨이항공,956,955,1911,189269,186758,376027,774,510,1285
"2024","2",폴라에어카고,45,44,89,0,0,0,1607,992,2599
"2024","2",폴란드항공,26,26,52,5933,5131,11064,205,250,455
"2024","2",피치항공,145,145,290,25894,25363,51257,0,9,9
"2024","2",핀에어,27,28,55,5620,4960,10580,597,459,1056
"2024","2",필리핀에어아시아,87,87,174,14345,13391,27736,5,19,24
"2024","2",필리핀항공,145,145,290,27724,26499,54223,35,161,197
"2024","2",하와이안 항공,20,20,40,4969,4865,9834,21,266,287
"2024","2",홍콩익스프레스,75,75,150,13367,13483,26850,13,8,21
"2024","2",홍콩항공,29,29,58,6350,7073,13423,349,129,478
"2024","2",FedEX항공,134,134,268,0,0,0,2612,2370,4982
"2024","2",KLM네덜란드항공,25,24,49,7600,6996,14596,323,269,592
"2024","3",가루다인도네시아,35,35,70,6019,5075,11094,93,285,378
"2024","3",그레이터베이항공,31,31,62,3763,2919,6682,40,20,60
"2024","3",내셔널항공,2,2,4,0,0,0,1,78,79
"2024","3",대한항공,3927,3926,7853,711927,644137,1356064,58942,55314,114255
"2024","3",델타항공,124,126,250,32266,35651,67917,134,1064,1198
"2024","3",라오항공,31,31,62,3567,2987,6554,1,10,11
"2024","3",로얄브루나이항공,13,13,26,1214,1114,2328,0,7,7
"2024","3",롱하오항공,33,33,66,0,0,0,409,208,618
"2024","3",루프트한자 독일항공,69,68,137,14102,11460,25562,709,1332,2040
"2024","3",말레이시아 항공,30,30,60,5812,5462,11274,352,461,813
"2024","3",몽골항공,50,49,99,7352,6312,13664,63,161,224
"2024","3",미얀마국제항공,15,15,30,1698,1077,2775,5,4,9
"2024","3",미얀마항공,6,6,12,857,34,891,1,2,3
"2024","3",바틱 에어 말레이시아,23,23,46,3359,2562,5921,0,8,8
"2024","3",베트남항공,186,186,372,48425,40225,88650,1230,690,1921
"2024","3",북경수도항공,2,2,4,329,167,496,0,0,0
"2024","3",비엣젯항공,422,423,845,85186,67884,153070,352,174,526
"2024","3",사우디아항공,13,13,26,837,1227,2064,28,193,221
"2024","3",사천항공,19,19,38,2600,2029,4629,0,12,12
"2024","3",산동항공,266,266,532,33016,25813,58829,391,12,403
"2024","3",상하이항공,30,30,60,4622,3508,8130,28,3,32
"2024","3",샤먼항공,45,45,90,5627,3376,9003,34,17,52
"2024","3",세부퍼시픽항공,77,77,154,17505,13066,30571,48,223,271
"2024","3",스리랑카항공,8,8,16,1826,1049,2875,67,104,171
"2024","3",스카이 앙코르 항공,25,25,50,3935,2791,6726,0,3,3
"2024","3",스쿠트 항공,32,31,63,10832,9407,20239,158,159,317
"2024","3",실크웨이웨스트항공,15,14,29,0,0,0,1122,1521,2643
"2024","3",심천항공,61,61,122,8335,6835,15170,83,9,92
"2024","3",싱가포르항공,147,146,293,36241,31420,67661,1949,1634,3582
"2024","3",아메리제트,23,23,46,0,0,0,25,519,544
"2024","3",아메리칸항공,31,31,62,8233,8706,16939,70,302,372
"2024","3",아시아나항공,2218,2215,4433,448919,409796,858715,25114,25183,50297
"2024","3",아틀라스항공,164,183,347,310,324,634,2694,736,3431
"2024","3",안토노프항공,0,1,1,0,0,0,0,41,41
"2024","3",에미레이트항공,44,44,88,15341,13928,29269,616,715,1331
"2024","3",에바항공,80,80,160,21126,19136,40262,671,433,1104
"2024","3",에어 뉴질랜드,12,12,24,3404,2466,5870,34,112,146
"2024","3",에어 아스타나,28,28,56,4809,3984,8793,5,47,51
"2024","3",에어 프랑스,28,28,56,9628,6831,16459,276,244,520
"2024","3",에어로 몽골리아,14,14,28,1319,920,2239,0,0,0
"2024","3",에어로로직,44,44,88,0,0,0,2086,537,2623
"2024","3",에어마카오,38,37,75,5321,4177,9498,47,7,54
"2024","3",에어부산,364,359,723,75806,74778,150584,18,2,20
"2024","3",에어서울,409,408,817,79519,78710,158229,62,56,117
"2024","3",에어아시아 버하드,28,27,55,4030,3866,7896,0,0,0
"2024","3",에어아시아엑스,43,43,86,13168,10760,23928,364,423,787
"2024","3",에어인디아 리미티드,18,18,36,4147,2471,6618,91,195,286
"2024","3",에어인천,155,155,310,0,0,0,2113,1490,3603
"2024","3",에어재팬,22,22,44,6093,5369,11462,87,110,197
"2024","3",에어캐나다,62,62,124,18441,18560,37001,497,655,1151
"2024","3",에어프레미아,109,109,218,32025,29527,61552,957,1044,2001
"2024","3",에어홍콩,26,25,51,0,0,0,1142,1137,2279
"2024","3",에티오피아항공,67,66,133,5017,3874,8891,1042,354,1396
"2024","3",에티하드 항공,31,31,62,8451,5900,14351,322,508,830
"2024","3",우즈베키스탄항공,30,30,60,6766,5978,12744,16,155,171
"2024","3",원통화물항공,51,51,102,0,0,0,1265,525,1790
"2024","3",유나이티드항공,31,31,62,7474,7003,14477,177,619,795
"2024","3",유피에스항공,121,120,241,0,0,0,1304,2630,3934
"2024","3",이스타항공,317,314,631,56186,54319,110505,0,0,0
"2024","3",일본항공,22,22,44,0,0,0,392,761,1153
"2024","3",전일본공수,27,27,54,0,0,0,776,950,1726
"2024","3",제주항공,1694,1685,3379,277049,258407,535456,1916,1431,3346
"2024","3",젯스타,31,31,62,9660,7842,17502,6,162,168
"2024","3",중국국제항공,223,223,446,29544,24500,54044,195,72,267
"2024","3",중국남방항공,457,457,914,59052,48349,107401,609,137,746
"2024","3",중국동방항공,533,532,1065,66422,52846,119268,878,464,1341
"2024","3",중국센트럴항공,34,34,68,0,0,0,529,192,721
"2024","3",중국우정항공,24,24,48,0,0,0,285,147,432
"2024","3",중국화물항공,12,12,24,0,0,0,1043,682,1725
"2024","3",중화항공,93,93,186,23815,22640,46455,707,507,1214
"2024","3",진에어,862,855,1717,205795,197629,403424,1266,870,2136
"2024","3",집에어,31,31,62,8318,7356,15674,251,249,501
"2024","3",천진항공,46,46,92,5105,4172,9277,2,7,9
"2024","3",청도항공,23,23,46,2355,1940,4295,23,4,27
"2024","3",춘추항공,36,36,72,5281,4243,9524,15,2,17
"2024","3",카고룩스 이탈리아 항공,13,13,26,0,0,0,800,604,1404
"2024","3",카고룩스항공,14,14,28,0,0,0,573,1020,1593
"2024","3",카타르항공,49,50,99,10633,9939,20572,1803,2128,3931
"2024","3",칼리타항공,78,79,157,0,0,0,1295,2028,3323
"2024","3",캐세이퍼시픽항공,136,136,272,31200,25232,56432,1823,828,2651
"2024","3",콴타스항공,17,17,34,4403,3071,7474,5,111,116
"2024","3",타이거에어 타이완,31,31,62,5256,3606,8862,1,46,46
"2024","3",타이에어아시아엑스,62,61,123,19839,17086,36925,779,210,989
"2024","3",타이항공,93,93,186,21486,16135,37621,1804,544,2348
"2024","3",터키항공,59,59,118,16150,13118,29268,1330,1722,3052
"2024","3",투르크메니스탄,4,4,8,0,0,0,184,147,332
"2024","3",티웨이항공,972,967,1939,189465,177454,366919,803,465,1268
"2024","3",폴라에어카고,43,41,84,0,0,0,2154,998,3153
"2024","3",폴란드항공,27,27,54,6289,4955,11244,239,308,548
"2024","3",피치항공,155,155,310,27588,26851,54439,0,11,11
"2024","3",핀에어,31,31,62,7099,4937,12036,673,481,1155
"2024","3",필리핀에어아시아,92,92,184,14601,10589,25190,3,20,23
"2024","3",필리핀항공,150,149,299,28983,25730,54713,46,245,291
"2024","3",하와이안 항공,23,23,46,5429,4730,10159,20,353,373
"2024","3",홍콩익스프레스,79,79,158,14525,10325,24850,24,24,48
"2024","3",홍콩항공,31,31,62,7611,6477,14088,408,135,544
"2024","3",FedEX항공,151,151,302,0,0,0,3086,2555,5641
"2024","3",KLM네덜란드항공,26,27,53,7863,7375,15238,353,339,693
"2024","3",MY FREIGHTER AIRLINES,1,1,2,0,0,0,8,33,41
"2024","3",ZP,1,0,1,0,0,0,10,0,10
"2024","4",가루다인도네시아,34,34,68,7563,8128,15691,112,202,314
"2024","4",그레이터베이항공,30,30,60,2754,3565,6319,37,24,61
"2024","4",내셔널항공,3,7,10,0,0,0,0,595,595
"2024","4",대한항공,3670,3658,7328,638404,647606,1286010,53536,52005,105541
"2024","4",델타항공,129,131,260,30661,37017,67678,143,1055,1197
"2024","4",라오항공,33,33,66,4062,3012,7074,2,10,13
"2024","4",로얄브루나이항공,13,13,26,1130,1360,2490,0,15,16
"2024","4",롱하오항공,36,36,72,0,0,0,446,242,688
"2024","4",루프트한자 독일항공,87,88,175,17029,18140,35169,838,1631,2469
"2024","4",말레이시아 항공,33,33,66,6625,7585,14210,361,395,756
"2024","4",몽골항공,52,52,104,6777,7458,14235,57,185,242
"2024","4",미얀마국제항공,15,15,30,1453,1229,2682,8,4,12
"2024","4",미얀마항공,2,2,4,287,19,306,0,1,1
"2024","4",바틱 에어 말레이시아,28,28,56,4439,4207,8646,0,21,21
"2024","4",베트남항공,180,180,360,40806,39938,80744,1105,646,1751
"2024","4",비엣젯항공,420,420,840,86637,76088,162725,446,166,613
"2024","4",사우디아항공,13,13,26,2176,1775,3951,23,170,193
"2024","4",사천항공,14,14,28,1898,1902,3800,33,11,44
"2024","4",산동항공,294,294,588,38699,39617,78316,435,6,440
"2024","4",상하이항공,30,30,60,4390,4510,8900,24,3,27
"2024","4",샤먼항공,58,58,116,7115,5987,13102,48,23,71
"2024","4",세부퍼시픽항공,90,90,180,20740,18468,39208,51,264,315
"2024","4",스리랑카항공,9,9,18,1496,1578,3074,83,123,206
"2024","4",스카이 앙코르 항공,17,17,34,2819,2596,5415,5,1,6
"2024","4",스쿠트 항공,39,40,79,12750,13226,25976,267,111,378
"2024","4",실크웨이웨스트항공,12,14,26,0,0,0,856,1438,2293
"2024","4",심천항공,63,63,126,8397,8446,16843,68,7,75
"2024","4",싱가포르항공,143,144,287,33633,37502,71135,1976,1536,3512
"2024","4",아메리제트,12,12,24,0,0,0,37,294,331
"2024","4",아메리칸항공,30,30,60,6977,8440,15417,82,287,369
"2024","4",아시아나항공,2083,2075,4158,391408,402891,794299,23062,22921,45983
"2024","4",아틀라스항공,193,188,381,0,0,0,2899,1268,4167
"2024","4",에미레이트항공,43,43,86,14640,17651,32291,331,602,933
"2024","4",에바항공,77,77,154,18387,19056,37443,684,348,1033
"2024","4",에어 아스타나,26,26,52,4659,5051,9710,11,122,132
"2024","4",에어 프랑스,29,29,58,9392,9748,19140,395,382,777
"2024","4",에어로 몽골리아,21,21,42,1355,1611,2966,0,0,0
"2024","4",에어로로직,45,45,90,0,0,0,1944,291,2235
"2024","4",에어마카오,58,59,117,7038,7378,14416,54,11,66
"2024","4",에어부산,347,346,693,69172,68277,137449,19,1,20
"2024","4",에어서울,402,401,803,75615,75345,150960,53,18,71
"2024","4",에어아시아 버하드,29,29,58,4083,3777,7860,0,0,0
"2024","4",에어아시아엑스,42,42,84,13045,11864,24909,305,293,597
"2024","4",에어인디아 리미티드,17,17,34,3702,3083,6785,117,164,280
"2024","4",에어인천,157,158,315,0,0,0,2056,1338,3395
"2024","4",에어재팬,22,22,44,4371,2758,7129,118,134,252
"2024","4",에어캐나다,60,60,120,20098,20860,40958,417,514,931
"2024","4",에어프레미아,103,103,206,29717,30599,60316,941,908,1848
"2024","4",에어홍콩,25,26,51,0,0,0,1040,960,2000
"2024","4",에티오피아항공,62,63,125,4411,3703,8114,1030,390,1420
"2024","4",에티하드 항공,30,30,60,7713,7905,15618,309,473,782
"2024","4",우즈베키스탄항공,30,30,60,6862,6928,13790,30,172,202
"2024","4",원통화물항공,49,49,98,0,0,0,909,464,1373
"2024","4",유나이티드항공,59,59,118,10144,13849,23993,189,910,1099
"2024","4",유피에스항공,110,113,223,0,0,0,1249,2262,3511
"2024","4",이스타항공,304,303,607,50767,49798,100565,0,0,0
"2024","4",일본항공,21,21,42,0,0,0,329,658,986
"2024","4",전일본공수,25,25,50,0,0,0,790,810,1600
"2024","4",제주항공,1684,1680,3364,269958,268171,538129,1717,1213,2930
"2024","4",젯스타,30,30,60,7875,7737,15612,19,180,199
"2024","4",중국국제항공,223,222,445,32480,33963,66443,463,110,573
"2024","4",중국남방항공,432,432,864,57699,60598,118297,447,121,568
"2024","4",중국동방항공,524,525,1049,71304,69791,141095,1049,530,1579
"2024","4",중국센트럴항공,33,33,66,0,0,0,425,133,558
"2024","4",중국우정항공,23,23,46,0,0,0,248,153,401
"2024","4",중국화물항공,10,10,20,0,0,0,873,478,1352
"2024","4",중화항공,90,90,180,20078,22806,42884,490,455,945
"2024","4",진에어,833,832,1665,183634,179999,363633,922,970,1892
"2024","4",집에어,30,30,60,7126,5131,12257,222,166,388
"2024","4",천진항공,32,32,64,3599,3782,7381,2,6,8
"2024","4",청도항공,25,25,50,3095,3400,6495,11,3,14
"2024","4",춘추항공,34,34,68,5210,4958,10168,3,4,7
"2024","4",카고룩스 이탈리아 항공,12,12,24,0,0,0,727,576,1302
"2024","4",카고룩스항공,12,12,24,0,0,0,492,871,1363
"2024","4",카타르항공,49,49,98,10572,11916,22488,1384,1853,3237
"2024","4",칼리타항공,95,93,188,0,0,0,1127,1868,2995
"2024","4",캐세이퍼시픽항공,129,128,257,28496,30649,59145,1491,772,2263
"2024","4",콴타스항공,13,13,26,3759,3677,7436,7,94,102
"2024","4",타이거에어 타이완,28,29,57,4388,4221,8609,3,31,34
"2024","4",타이에어아시아엑스,60,60,120,18920,17886,36806,801,154,955
"2024","4",타이항공,90,90,180,20736,18980,39716,1789,621,2409
"2024","4",터키항공,55,56,111,14405,15511,29916,1263,1570,2832
"2024","4",투르크메니스탄,5,4,9,0,0,0,121,179,300
"2024","4",티웨이항공,890,891,1781,171823,170433,342256,966,564,1530
"2024","4",폴라에어카고,89,90,179,0,0,0,2866,2334,5200
"2024","4",폴란드항공,46,46,92,9339,10371,19710,279,436,715
"2024","4",피치항공,149,149,298,24377,23109,47486,0,9,9
"2024","4",핀에어,30,30,60,6983,9213,16196,633,434,1067
"2024","4",필리핀에어아시아,60,60,120,8819,8324,17143,4,20,24
"2024","4",필리핀항공,90,91,181,15193,18624,33817,39,200,238
"2024","4",하와이안 항공,21,21,42,4512,4901,9413,41,347,388
"2024","4",홍콩익스프레스,89,88,177,14193,14031,28224,19,19,38
"2024","4",홍콩항공,22,22,44,3641,4817,8458,182,46,228
"2024","4",FedEX항공,146,145,291,0,0,0,3044,2713,5758
"2024","4",GM,1,0,1,0,0,0,2,0,2
"2024","4",KLM네덜란드항공,25,25,50,8043,8636,16679,369,337,706
"2024","4",MJ,0,1,1,0,0,0,0,7,7
"2024","4",MY FREIGHTER AIRLINES,1,1,2,0,0,0,7,14,21
"2024","4",ZP,1,2,3,0,0,0,2,11,12
"2024","5",가루다인도네시아,35,35,70,7237,7035,14272,157,211,368
"2024","5",그레이터베이항공,30,30,60,3626,4038,7664,33,23,56
"2024","5",내셔널항공,0,5,5,0,0,0,0,327,327
"2024","5",대한항공,3906,3913,7819,666275,666247,1332522,55362,53417,108780
"2024","5",델타항공,151,157,308,41797,39396,81193,86,1396,1482
"2024","5",라오항공,32,32,64,2915,2225,5140,3,3,6
"2024","5",로얄브루나이항공,13,13,26,1047,995,2042,0,9,9
"2024","5",롱하오항공,33,33,66,0,0,0,430,265,695
"2024","5",루프트한자 독일항공,85,84,169,17536,18541,36077,770,1398,2168
"2024","5",말레이시아 항공,50,49,99,8184,8737,16921,541,459,1000
"2024","5",몽골항공,65,65,130,9763,10830,20593,39,263,302
"2024","5",미얀마국제항공,14,14,28,1366,1042,2408,13,3,16
"2024","5",미얀마항공,6,6,12,908,29,937,4,2,6
"2024","5",바틱 에어 말레이시아,30,30,60,3988,3242,7230,0,43,43
"2024","5",베트남항공,186,186,372,34824,36803,71627,1125,826,1951
"2024","5",비엣젯항공,434,434,868,84059,75127,159186,396,201,597
"2024","5",사우디아항공,12,12,24,1799,1810,3609,23,169,192
"2024","5",사천항공,13,13,26,1905,1871,3776,1,10,11
"2024","5",산동항공,310,310,620,39751,43259,83010,524,8,532
"2024","5",상하이항공,31,31,62,4485,4542,9027,30,2,32
"2024","5",샤먼항공,45,45,90,5419,5552,10971,35,21,56
"2024","5",세부퍼시픽항공,87,87,174,18432,15324,33756,58,277,335
"2024","5",스리랑카항공,9,9,18,1978,1477,3455,96,115,211
"2024","5",스위스 국제항공,10,10,20,1889,2027,3916,89,122,211
"2024","5",스카이 앙코르 항공,17,17,34,2610,1946,4556,3,3,6
"2024","5",스쿠트 항공,40,40,80,13054,12366,25420,286,166,453
"2024","5",실크웨이웨스트항공,8,8,16,0,0,0,504,857,1361
"2024","5",심천항공,68,68,136,8297,8253,16550,74,7,81
"2024","5",싱가포르항공,151,150,301,35525,35839,71364,2057,1718,3774
"2024","5",아메리제트,9,9,18,0,0,0,23,261,285
"2024","5",아메리칸항공,31,31,62,8369,8653,17022,95,308,403
"2024","5",아시아나항공,2254,2258,4512,417484,429173,846657,25328,25440,50767
"2024","5",아틀라스항공,183,189,372,0,0,0,2866,1011,3877
"2024","5",에미레이트항공,45,45,90,17962,19152,37114,309,570,878
"2024","5",에바항공,80,80,160,18126,17365,35491,719,369,1088
"2024","5",에어 아스타나,26,26,52,4350,4649,8999,17,114,130
"2024","5",에어 프랑스,31,31,62,9943,10348,20291,406,446,852
"2024","5",에어로 몽골리아,22,22,44,1729,1920,3649,0,0,0
"2024","5",에어로로직,44,44,88,0,0,0,2084,251,2335
"2024","5",에어로케이항공,2,2,4,331,276,607,0,0,0
"2024","5",에어마카오,60,59,119,6511,6816,13327,60,13,73
"2024","5",에어부산,360,359,719,68158,70868,139026,22,0,22
"2024","5",에어서울,417,417,834,77263,78436,155699,44,18,63
"2024","5",에어아시아 버하드,31,31,62,4433,3969,8402,0,0,0
"2024","5",에어아시아엑스,45,45,90,13152,11604,24756,356,341,697
"2024","5",에어인디아 리미티드,17,17,34,3453,2634,6087,96,182,278
"2024","5",에어인천,164,164,328,0,0,0,2064,1502,3566
"2024","5",에어재팬,31,31,62,4964,4224,9188,120,160,280
"2024","5",에어캐나다,62,62,124,21005,21476,42481,327,605,931
"2024","5",에어프레미아,107,107,214,30464,29365,59829,1080,1012,2092
"2024","5",에어홍콩,26,26,52,0,0,0,1101,1114,2214
"2024","5",에티오피아항공,67,66,133,4997,4432,9429,1075,417,1492
"2024","5",에티하드 항공,49,48,97,11502,11357,22859,506,700,1206
"2024","5",우즈베키스탄항공,31,31,62,6987,7152,14139,25,195,221
"2024","5",원통화물항공,45,45,90,0,0,0,981,570,1551
"2024","5",웨스트젯,6,6,12,1902,1831,3733,1,78,79
"2024","5",유나이티드항공,62,62,124,14834,11750,26584,434,874,1308
"2024","5",유피에스항공,124,123,247,0,0,0,1442,2457,3899
"2024","5",이스타항공,313,312,625,47609,49027,96636,0,0,0
"2024","5",일본항공,22,22,44,0,0,0,348,674,1022
"2024","5",전일본공수,27,27,54,0,0,0,765,827,1592
"2024","5",제주항공,1709,1709,3418,269430,269774,539204,1424,1059,2483
"2024","5",젯스타,31,31,62,8310,8006,16316,22,191,213
"2024","5",중국국제항공,269,269,538,35671,41927,77598,651,121,772
"2024","5",중국남방항공,458,458,916,54206,61150,115356,557,150,707
"2024","5",중국동방항공,493,493,986,64916,68756,133672,1105,474,1579
"2024","5",중국센트럴항공,23,23,46,0,0,0,319,89,408
"2024","5",중국우정항공,21,21,42,0,0,0,209,151,361
"2024","5",중국화물항공,10,10,20,0,0,0,876,467,1344
"2024","5",중화항공,93,93,186,19194,19820,39014,642,431,1073
"2024","5",진에어,876,872,1748,187272,185946,373218,970,777,1747
"2024","5",집에어,31,31,62,7427,6620,14047,238,197,435
"2024","5",천진항공,34,34,68,3858,4343,8201,3,3,6
"2024","5",천진화물항공,6,6,12,0,0,0,56,2,57
"2024","5",청도항공,27,27,54,3266,3875,7141,36,3,38
"2024","5",춘추항공,29,29,58,4287,4281,8568,12,6,18
"2024","5",카고룩스 이탈리아 항공,13,13,26,0,0,0,522,561,1083
"2024","5",카고룩스항공,13,13,26,0,0,0,453,934,1386
"2024","5",카타르항공,55,54,109,12441,13097,25538,1410,1959,3369
"2024","5",칼리타항공,89,89,178,0,0,0,1615,982,2597
"2024","5",캐세이퍼시픽항공,128,128,256,26440,26551,52991,1414,719,2133
"2024","5",콴타스항공,18,18,36,4528,4351,8879,82,102,184
"2024","5",타이거에어 타이완,32,31,63,4811,3391,8202,2,47,49
"2024","5",타이에어아시아엑스,47,47,94,13229,13604,26833,612,315,927
"2024","5",타이항공,93,93,186,15137,14776,29913,1867,647,2514
"2024","5",터키항공,58,58,116,14550,14162,28712,1224,1738,2961
"2024","5",투르크메니스탄,4,5,9,0,0,0,79,183,261
"2024","5",티웨이항공,944,943,1887,174211,174348,348559,739,467,1206
"2024","5",폴라에어카고,74,74,148,0,0,0,2801,2851,5652
"2024","5",폴란드항공,49,49,98,9127,10654,19781,206,410,616
"2024","5",피치항공,155,155,310,25498,24237,49735,0,9,9
"2024","5",핀에어,31,31,62,8774,9423,18197,585,442,1026
"2024","5",필리핀에어아시아,50,50,100,6964,6255,13219,3,19,22
"2024","5",필리핀항공,94,93,187,15646,16041,31687,24,178,203
"2024","5",하와이안 항공,22,22,44,5873,4598,10471,38,310,348
"2024","5",홍콩익스프레스,85,86,171,13990,13387,27377,23,19,42
"2024","5",홍콩항공,23,23,46,2604,2748,5352,26,0,26
"2024","5",FedEX항공,156,157,313,0,0,0,3053,2722,5775
"2024","5",KLM네덜란드항공,26,26,52,8667,9214,17881,386,408,794
"2024","5",MY FREIGHTER AIRLINES,1,1,2,0,0,0,0,9,9
"2024","5",ZP,1,1,2,0,0,0,8,0,8
"2024","6",가루다인도네시아,35,35,70,7603,7396,14999,130,218,349
"2024","6",그레이터베이항공,32,32,64,3872,3943,7815,38,22,60
"2024","6",내셔널항공,1,3,4,0,0,0,0,248,248
"2024","6",대한항공,3815,3813,7628,673269,665863,1339132,55569,54774,110343
"2024","6",델타항공,150,150,300,42322,41851,84173,155,1334,1489
"2024","6",라오항공,21,21,42,1631,1837,3468,14,6,19
"2024","6",로얄브루나이항공,13,13,26,912,1033,1945,0,11,11
"2024","6",롱하오항공,39,39,78,0,0,0,538,226,764
"2024","6",루프트한자 독일항공,88,88,176,17144,17798,34942,1050,1676,2726
"2024","6",말레이시아 항공,44,45,89,7399,8907,16306,494,416,910
"2024","6",몽골항공,74,74,148,13252,15574,28826,29,325,354
"2024","6",미얀마국제항공,12,12,24,1195,1031,2226,13,5,17
"2024","6",미얀마항공,4,4,8,605,27,632,2,2,4
"2024","6",바틱 에어 말레이시아,30,30,60,3819,3085,6904,1,37,38
"2024","6",베트남항공,180,180,360,36547,39768,76315,1196,825,2021
"2024","6",비엣젯항공,430,428,858,85015,79890,164905,299,168,467
"2024","6",사우디아항공,10,10,20,2283,1689,3972,6,115,120
"2024","6",사천항공,13,13,26,1770,1820,3590,0,11,11
"2024","6",산동항공,293,292,585,36729,41624,78353,438,13,451
"2024","6",상하이항공,30,30,60,4623,4508,9131,25,3,28
"2024","6",샤먼항공,55,55,110,6633,6886,13519,45,13,58
"2024","6",세부퍼시픽항공,90,90,180,19508,17143,36651,94,371,465
"2024","6",순풍항공,1,1,2,0,0,0,19,7,26
"2024","6",스리랑카항공,8,8,16,1112,1228,2340,85,118,204
"2024","6",스위스 국제항공,12,12,24,2374,2356,4730,122,157,279
"2024","6",스카이 앙코르 항공,14,14,28,1999,1883,3882,0,2,2
"2024","6",스쿠트 항공,35,35,70,11586,10994,22580,147,92,238
"2024","6",실크웨이웨스트항공,9,9,18,0,0,0,624,1019,1643
"2024","6",심천항공,64,64,128,8694,8716,17410,68,8,76
"2024","6",싱가포르항공,144,144,288,31810,35630,67440,1409,1670,3079
"2024","6",아메리칸항공,30,30,60,8397,8497,16894,101,290,392
"2024","6",아시아나항공,2143,2143,4286,420533,425151,845684,24872,24365,49238
"2024","6",아틀라스항공,174,177,351,0,0,0,2772,1167,3939
"2024","6",에미레이트항공,42,42,84,16596,17123,33719,306,623,929
"2024","6",에바항공,77,77,154,18605,18086,36691,645,387,1032
"2024","6",에어 아스타나,35,35,70,5372,5457,10829,11,112,124
"2024","6",에어 프랑스,30,30,60,10254,9596,19850,369,458,827
"2024","6",에어로 몽골리아,26,26,52,2615,2726,5341,0,0,0
"2024","6",에어로로직,44,44,88,0,0,0,2060,264,2324
"2024","6",에어로케이항공,33,34,67,5182,5078,10260,0,0,0
"2024","6",에어마카오,58,58,116,6530,6609,13139,86,17,103
"2024","6",에어부산,348,348,696,69829,72252,142081,13,15,29
"2024","6",에어서울,402,404,806,75824,77290,153114,43,29,72
"2024","6",에어아시아 버하드,29,30,59,4286,4753,9039,0,0,0
"2024","6",에어아시아엑스,34,34,68,9356,9128,18484,296,387,683
"2024","6",에어인디아 리미티드,18,18,36,3394,3950,7344,90,210,300
"2024","6",에어인천,169,167,336,0,0,0,2043,1420,3463
"2024","6",에어재팬,30,30,60,5403,4882,10285,134,155,288
"2024","6",에어캐나다,67,67,134,22657,22507,45164,441,665,1107
"2024","6",에어프레미아,117,118,235,32731,31654,64385,1044,1218,2262
"2024","6",에어홍콩,26,25,51,0,0,0,1163,1099,2261
"2024","6",에티오피아항공,62,62,124,5234,5199,10433,917,300,1217
"2024","6",에티하드 항공,47,47,94,11678,10193,21871,423,714,1137
"2024","6",우즈베키스탄항공,30,30,60,6922,6968,13890,51,170,221
"2024","6",원통화물항공,50,50,100,0,0,0,1114,453,1568
"2024","6",웨스트젯,13,13,26,3900,4054,7954,11,210,221
"2024","6",유나이티드항공,60,60,120,15602,14768,30370,302,967,1268
"2024","6",유피에스항공,120,119,239,0,0,0,1809,2241,4050
"2024","6",이스타항공,303,301,604,50998,51198,102196,0,0,0
"2024","6",일본항공,21,21,42,0,0,0,408,751,1159
"2024","6",장쑤징동화물항공,2,2,4,0,0,0,15,5,19
"2024","6",전일본공수,26,26,52,0,0,0,810,885,1695
"2024","6",제주항공,1667,1662,3329,267716,266957,534673,1481,1137,2619
"2024","6",젯스타,30,30,60,8359,8002,16361,18,193,211
"2024","6",중국국제항공,263,263,526,40480,43609,84089,569,116,685
"2024","6",중국남방항공,483,483,966,61926,67887,129813,568,144,713
"2024","6",중국동방항공,544,541,1085,76663,77992,154655,1028,479,1507
"2024","6",중국센트럴항공,40,40,80,0,0,0,570,158,728
"2024","6",중국연합항공,4,4,8,461,604,1065,0,0,0
"2024","6",중국우정항공,25,25,50,0,0,0,284,175,459
"2024","6",중국화물항공,12,12,24,0,0,0,1019,659,1678
"2024","6",중화항공,90,90,180,19251,19663,38914,471,490,960
"2024","6",진에어,898,898,1796,194012,192585,386597,551,803,1354
"2024","6",집에어,30,30,60,7801,7093,14894,228,243,472
"2024","6",천진항공,16,16,32,1999,2139,4138,1,2,3
"2024","6",천진화물항공,18,18,36,0,0,0,202,6,208
"2024","6",청도항공,30,30,60,3699,4231,7930,20,5,24
"2024","6",춘추항공,29,29,58,4432,4576,9008,4,3,7
"2024","6",카고룩스 이탈리아 항공,12,12,24,0,0,0,532,573,1105
"2024","6",카고룩스항공,14,14,28,0,0,0,445,1000,1445
"2024","6",카놋샤크,4,4,8,383,284,667,0,0,0
"2024","6",카타르항공,51,52,103,11812,11720,23532,1289,2181,3470
"2024","6",칼리타항공,82,84,166,0,0,0,2350,367,2717
"2024","6",캐세이퍼시픽항공,125,125,250,28793,27074,55867,1431,826,2257
"2024","6",콴타스항공,13,13,26,3717,3252,6969,2,110,111
"2024","6",타이거에어 타이완,30,30,60,5002,3143,8145,0,46,46
"2024","6",타이에어아시아엑스,43,43,86,12378,13230,25608,420,271,691
"2024","6",타이항공,90,90,180,15104,16452,31556,1452,651,2103
"2024","6",터키항공,56,56,112,14773,13860,28633,1299,1757,3056
"2024","6",투르크메니스탄,4,4,8,0,0,0,68,166,234
"2024","6",티웨이항공,937,935,1872,176952,176258,353210,645,526,1171
"2024","6",폴라에어카고,74,76,150,0,0,0,2847,3536,6383
"2024","6",폴란드항공,40,40,80,8874,7747,16621,166,442,609
"2024","6",피치항공,150,150,300,24857,22951,47808,0,10,10
"2024","6",핀에어,30,30,60,9067,8651,17718,486,436,922
"2024","6",필리핀에어아시아,30,30,60,4685,4617,9302,5,17,22
"2024","6",필리핀항공,90,90,180,15500,16705,32205,16,173,189
"2024","6",하와이안 항공,22,22,44,5933,5289,11222,23,369,391
"2024","6",홍콩익스프레스,81,81,162,12917,11911,24828,25,16,41
"2024","6",홍콩항공,21,21,42,2886,2713,5599,31,0,31
"2024","6",FedEX항공,145,145,290,0,0,0,3273,2911,6183
"2024","6",KLM네덜란드항공,23,23,46,7657,7685,15342,311,369,680
"2024","6",MY FREIGHTER AIRLINES,1,1,2,0,0,0,3,17,20
"2024","6",RON,1,1,2,5,0,5,0,0,0
"2024","7",가루다인도네시아,51,51,102,9787,12000,21787,150,345,496
"2024","7",그레이터베이항공,31,31,62,2906,4790,7696,27,18,45
"2024","7",내셔널항공,4,7,11,0,0,0,0,513,513
"2024","7",대한항공,3971,3969,7940,667711,705165,1372876,55119,55513,110632
"2024","7",델타항공,149,151,300,37905,43657,81562,130,983,1114
"2024","7",라오항공,22,22,44,2113,2344,4457,29,7,36
"2024","7",로얄브루나이항공,14,14,28,825,1169,1994,0,13,14
"2024","7",롱하오항공,40,40,80,0,0,0,542,186,728
"2024","7",루프트한자 독일항공,81,81,162,15578,15777,31355,883,1408,2290
"2024","7",말레이시아 항공,45,45,90,6904,10623,17527,354,457,811
"2024","7",몽골항공,104,104,208,20077,23217,43294,92,311,404
"2024","7",미얀마국제항공,13,13,26,986,1345,2331,12,8,19
"2024","7",미얀마항공,6,6,12,875,32,907,4,3,7
"2024","7",바틱 에어 말레이시아,31,31,62,4649,4992,9641,3,25,28
"2024","7",베트남항공,186,186,372,38017,44439,82456,1236,873,2109
"2024","7",비엣젯항공,458,459,917,88878,92173,181051,359,124,482
"2024","7",사천항공,13,13,26,1729,1780,3509,1,10,11
"2024","7",산동항공,304,305,609,39702,40926,80628,439,28,467
"2024","7",상하이항공,31,31,62,4533,4653,9186,11,2,13
"2024","7",샤먼항공,56,56,112,7342,7200,14542,39,16,55
"2024","7",세부퍼시픽항공,86,86,172,14515,15815,30330,34,120,154
"2024","7",스리랑카항공,10,10,20,1819,2192,4011,124,135,259
"2024","7",스위스 국제항공,14,14,28,2863,2794,5657,181,203,384
"2024","7",스카이 앙코르 항공,14,14,28,2217,2373,4590,3,4,7
"2024","7",스쿠트 항공,31,31,62,9598,10097,19695,48,78,126
"2024","7",실크웨이웨스트항공,9,9,18,0,0,0,554,872,1426
"2024","7",심천항공,66,66,132,8452,8806,17258,54,9,64
"2024","7",싱가포르항공,151,151,302,24128,30011,54139,1298,1856,3154
"2024","7",아메리칸항공,31,31,62,6448,8789,15237,99,258,356
"2024","7",아시아나항공,2354,2353,4707,443396,479550,922946,24950,24505,49455
"2024","7",아틀라스항공,176,169,345,0,0,0,2584,578,3162
"2024","7",에미레이트항공,45,45,90,16740,17885,34625,371,582,953
"2024","7",에바항공,85,85,170,15405,18303,33708,556,333,888
"2024","7",에어 아스타나,39,39,78,5898,6485,12383,12,147,159
"2024","7",에어 프랑스,31,31,62,10676,9457,20133,331,452,784
"2024","7",에어로 몽골리아,26,26,52,2571,3323,5894,0,0,0
"2024","7",에어로로직,50,49,99,0,0,0,2540,332,2873
"2024","7",에어로케이항공,49,49,98,7926,7453,15379,0,0,0
"2024","7",에어마카오,57,57,114,6691,7032,13723,41,9,50
"2024","7",에어부산,361,359,720,72856,75935,148791,2,11,13
"2024","7",에어서울,416,415,831,77098,80168,157266,42,8,50
"2024","7",에어아시아 버하드,31,31,62,4986,5158,10144,0,0,0
"2024","7",에어아시아엑스,39,39,78,10739,12128,22867,230,303,533
"2024","7",에어인디아 리미티드,17,17,34,3071,3717,6788,136,205,341
"2024","7",에어인천,168,170,338,0,0,0,2239,1594,3833
"2024","7",에어재팬,31,31,62,6600,6152,12752,145,76,220
"2024","7",에어캐나다,80,80,160,25799,26532,52331,617,731,1348
"2024","7",에어프레미아,122,122,244,32620,35872,68492,783,1195,1978
"2024","7",에어홍콩,26,27,53,0,0,0,1122,1202,2324
"2024","7",에티오피아항공,66,66,132,5519,5618,11137,929,450,1380
"2024","7",에티하드 항공,49,49,98,12718,12006,24724,426,787,1213
"2024","7",우즈베키스탄항공,31,31,62,6940,7366,14306,23,239,262
"2024","7",원통화물항공,52,52,104,0,0,0,1020,147,1166
"2024","7",웨스트젯,13,13,26,3881,4077,7958,3,217,220
"2024","7",유나이티드항공,61,61,122,13092,16116,29208,183,926,1110
"2024","7",유피에스항공,122,123,245,0,0,0,1584,2370,3954
"2024","7",이스타항공,397,395,792,65587,69085,134672,0,0,0
"2024","7",일본항공,22,22,44,0,0,0,392,741,1133
"2024","7",장쑤징동화물항공,13,13,26,0,0,0,178,4,182
"2024","7",전일본공수,26,26,52,0,0,0,761,735,1496
"2024","7",제주항공,1734,1731,3465,273380,287648,561028,1356,1128,2484
"2024","7",젯스타,29,30,59,7142,9249,16391,14,200,214
"2024","7",중국국제항공,299,299,598,46170,47844,94014,480,117,597
"2024","7",중국남방항공,493,493,986,65144,71832,136976,499,133,632
"2024","7",중국동방항공,599,599,1198,79331,81384,160715,1058,504,1562
"2024","7",중국센트럴항공,44,44,88,0,0,0,619,183,803
"2024","7",중국연합항공,9,9,18,1495,1512,3007,0,0,0
"2024","7",중국우정항공,20,20,40,0,0,0,164,191,354
"2024","7",중국화물항공,11,11,22,0,0,0,971,594,1565
"2024","7",중화항공,91,91,182,14972,19858,34830,483,406,889
"2024","7",진에어,998,1000,1998,207340,216176,423516,624,780,1404
"2024","7",집에어,31,31,62,7801,6999,14800,199,205,403
"2024","7",천진항공,27,27,54,3461,3360,6821,5,0,5
"2024","7",천진화물항공,21,21,42,0,0,0,275,17,292
"2024","7",청도항공,29,29,58,4075,4254,8329,29,3,32
"2024","7",춘추항공,35,35,70,5578,5521,11099,4,3,7
"2024","7",카고룩스 이탈리아 항공,15,15,30,0,0,0,611,697,1308
"2024","7",카고룩스항공,12,12,24,0,0,0,509,817,1326
"2024","7",카놋샤크,9,9,18,1324,1152,2476,0,0,0
"2024","7",카타르항공,52,52,104,11726,12237,23963,1183,2074,3257
"2024","7",칼리타항공,100,98,198,0,0,0,2391,823,3214
"2024","7",캐세이퍼시픽항공,136,136,272,27321,30921,58242,1131,789,1920
"2024","7",콴타스항공,13,13,26,2489,3726,6215,14,82,95
"2024","7",타이거에어 타이완,31,31,62,5074,3658,8732,2,38,41
"2024","7",타이에어아시아엑스,44,45,89,12860,14672,27532,380,230,611
"2024","7",타이항공,91,91,182,14918,21434,36352,870,626,1496
"2024","7",터키항공,57,57,114,15101,13409,28510,1197,1619,2817
"2024","7",투르크메니스탄,5,5,10,0,0,0,57,174,231
"2024","7",티웨이항공,1026,1029,2055,191870,199668,391538,673,545,1218
"2024","7",폴라에어카고,59,60,119,0,0,0,1889,2934,4824
"2024","7",폴란드항공,44,44,88,10766,9490,20256,167,418,585
"2024","7",피치항공,155,155,310,24975,23480,48455,0,10,10
"2024","7",핀에어,31,31,62,9580,9463,19043,546,421,967
"2024","7",필리핀에어아시아,31,31,62,3908,4949,8857,2,8,10
"2024","7",필리핀항공,117,117,234,19438,23696,43134,16,170,185
"2024","7",하와이안 항공,22,22,44,4437,6019,10456,16,287,303
"2024","7",홍콩익스프레스,92,92,184,14739,14644,29383,18,13,31
"2024","7",홍콩항공,29,29,58,4425,4903,9328,113,14,127
"2024","7",FedEX항공,157,157,314,0,0,0,3118,2894,6013
"2024","7",KLM네덜란드항공,23,23,46,7858,7714,15572,350,354,704
"2024","7",MY FREIGHTER AIRLINES,2,2,4,0,0,0,5,52,57
"2024","8",가루다인도네시아,54,54,108,12998,11259,24257,175,330,505
"2024","8",그레이터베이항공,31,31,62,4023,4789,8812,18,13,32
"2024","8",내셔널항공,1,1,2,0,0,0,0,99,99
"2024","8",대한항공,4013,4010,8023,741307,693269,1434576,52796,54127,106923
"2024","8",델타항공,155,158,313,37724,45731,83455,131,1066,1196
"2024","8",라오항공,23,23,46,2591,2364,4955,19,5,25
"2024","8",로얄브루나이항공,13,13,26,1056,849,1905,0,13,13
"2024","8",롱하오항공,37,37,74,0,0,0,513,217,730
"2024","8",루프트한자 독일항공,72,73,145,16542,16130,32672,754,1045,1799
"2024","8",말레이시아 항공,40,40,80,9823,7365,17188,373,474,847
"2024","8",몽골항공,102,102,204,23959,22925,46884,41,263,304
"2024","8",미얀마국제항공,14,14,28,1616,1193,2809,7,6,12
"2024","8",미얀마항공,6,6,12,885,20,905,1,3,4
"2024","8",바틱 에어 말레이시아,31,31,62,5179,4158,9337,5,23,28
"2024","8",베트남항공,186,186,372,44120,40467,84587,1198,894,2092
"2024","8",비엣젯항공,465,464,929,94637,78891,173528,526,88,614
"2024","8",사천항공,14,14,28,2145,2023,4168,0,14,14
"2024","8",산동항공,310,309,619,46973,42975,89948,435,34,469
"2024","8",상하이항공,31,31,62,4883,4517,9400,16,2,18
"2024","8",샤먼항공,62,62,124,9275,7488,16763,35,15,50
"2024","8",세부퍼시픽항공,93,93,186,18939,14740,33679,33,160,193
"2024","8",순풍항공,4,4,8,0,0,0,9,6,15
"2024","8",스리랑카항공,8,8,16,2081,1115,3196,71,107,178
"2024","8",스위스 국제항공,13,13,26,2712,2622,5334,183,135,318
"2024","8",스카이 앙코르 항공,17,17,34,2729,2084,4813,2,2,3
"2024","8",스쿠트 항공,36,36,72,12109,11192,23301,90,82,172
"2024","8",실크웨이웨스트항공,8,8,16,0,0,0,460,853,1313
"2024","8",심천항공,66,66,132,9267,9134,18401,69,8,77
"2024","8",싱가포르항공,150,150,300,30442,26204,56646,1300,1707,3006
"2024","8",아메리칸항공,31,31,62,6257,8637,14894,84,259,344
"2024","8",아시아나항공,2380,2376,4756,506308,479131,985439,23073,23567,46640
"2024","8",아에로멕시코,29,29,58,6135,6391,12526,22,136,158
"2024","8",아틀라스항공,176,197,373,0,0,0,2351,306,2657
"2024","8",에미레이트항공,44,44,88,17805,16731,34536,510,462,973
"2024","8",에바항공,89,89,178,18786,17871,36657,483,374,857
"2024","8",에어 아스타나,40,40,80,7096,6527,13623,14,146,160
"2024","8",에어 프랑스,31,31,62,10759,10458,21217,467,483,950
"2024","8",에어로 몽골리아,30,30,60,4097,3465,7562,0,0,0
"2024","8",에어로로직,41,41,82,0,0,0,1966,158,2124
"2024","8",에어로케이항공,52,52,104,8576,7402,15978,0,0,0
"2024","8",에어마카오,62,62,124,7426,7132,14558,63,7,70
"2024","8",에어부산,362,362,724,71254,66360,137614,5,11,16
"2024","8",에어서울,413,413,826,77096,73975,151071,71,2,73
"2024","8",에어아시아 버하드,31,31,62,5141,4750,9891,0,0,0
"2024","8",에어아시아엑스,40,40,80,13652,10941,24593,201,280,481
"2024","8",에어인디아 리미티드,18,18,36,4129,3262,7391,52,171,224
"2024","8",에어인천,124,122,246,0,0,0,1714,1322,3037
"2024","8",에어재팬,30,30,60,8354,6203,14557,120,38,158
"2024","8",에어캐나다,79,79,158,23812,26645,50457,389,676,1066
"2024","8",에어프레미아,118,118,236,31288,33762,65050,656,1143,1799
"2024","8",에어홍콩,27,27,54,0,0,0,1176,1149,2325
"2024","8",에티오피아항공,66,66,132,5653,4435,10088,1055,340,1394
"2024","8",에티하드 항공,48,49,97,13296,12230,25526,420,762,1182
"2024","8",우즈베키스탄항공,31,31,62,7444,7286,14730,23,254,277
"2024","8",원통화물항공,47,47,94,0,0,0,968,303,1272
"2024","8",웨스트젯,14,14,28,4253,4427,8680,5,195,200
"2024","8",유나이티드항공,62,62,124,11728,16027,27755,293,925,1218
"2024","8",유피에스항공,126,126,252,0,0,0,1424,2894,4319
"2024","8",이스타항공,448,443,891,73184,68186,141370,0,0,0
"2024","8",일본항공,22,22,44,0,0,0,385,631,1016
"2024","8",장쑤징동화물항공,14,14,28,0,0,0,217,1,218
"2024","8",전일본공수,26,26,52,0,0,0,711,704,1414
"2024","8",제주항공,1704,1694,3398,280453,265052,545505,1048,838,1886
"2024","8",젯스타,31,31,62,9291,8594,17885,17,239,256
"2024","8",중국국제항공,314,314,628,50165,46275,96440,419,106,524
"2024","8",중국남방항공,509,509,1018,79438,74626,154064,519,118,637
"2024","8",중국동방항공,619,620,1239,95244,88278,183522,1070,484,1555
"2024","8",중국센트럴항공,37,37,74,0,0,0,550,172,722
"2024","8",중국연합항공,9,9,18,1499,1485,2984,0,0,0
"2024","8",중국우정항공,24,24,48,0,0,0,220,170,390
"2024","8",중국화물항공,12,12,24,0,0,0,1038,643,1680
"2024","8",중화항공,93,93,186,17811,17451,35262,485,407,892
"2024","8",진에어,1101,1097,2198,230944,217034,447978,808,733,1540
"2024","8",집에어,30,30,60,8035,6541,14576,204,170,373
"2024","8",천진항공,19,19,38,2842,2556,5398,3,1,4
"2024","8",천진화물항공,31,31,62,0,0,0,468,1,469
"2024","8",청도항공,31,31,62,4675,4178,8853,15,5,19
"2024","8",춘추항공,35,35,70,6161,5826,11987,4,3,8
"2024","8",카고룩스 이탈리아 항공,12,12,24,0,0,0,559,485,1044
"2024","8",카고룩스항공,14,14,28,0,0,0,492,977,1469
"2024","8",카놋샤크,9,9,18,1700,1388,3088,0,0,0
"2024","8",카타르항공,53,53,106,12969,13031,26000,1369,1833,3202
"2024","8",칼리타항공,102,100,202,0,0,0,1479,657,2136
"2024","8",캐세이퍼시픽항공,131,131,262,33611,30651,64262,997,775,1773
"2024","8",콴타스항공,14,14,28,3985,3191,7176,4,101,106
"2024","8",타이거에어 타이완,31,31,62,5340,3823,9163,5,22,27
"2024","8",타이에어아시아엑스,44,44,88,13938,12018,25956,267,218,485
"2024","8",타이항공,93,93,186,23453,19006,42459,1056,651,1707
"2024","8",터키항공,57,57,114,16613,14202,30815,1229,1492,2721
"2024","8",투르크메니스탄,4,4,8,0,0,0,54,123,177
"2024","8",티웨이항공,1043,1041,2084,199153,189612,388765,735,571,1306
"2024","8",폴라에어카고,52,53,105,0,0,0,2075,2591,4666
"2024","8",폴란드항공,43,43,86,10818,10381,21199,130,404,534
"2024","8",피치항공,155,155,310,25258,23255,48513,0,8,8
"2024","8",핀에어,31,31,62,9750,9584,19334,670,426,1096
"2024","8",필리핀에어아시아,31,31,62,4639,4061,8700,4,6,11
"2024","8",필리핀항공,123,123,246,23177,20152,43329,13,146,159
"2024","8",하와이안 항공,22,22,44,4953,5770,10723,15,280,295
"2024","8",홍콩익스프레스,93,93,186,16721,17264,33985,21,7,27
"2024","8",홍콩항공,31,31,62,4515,4131,8646,46,8,54
"2024","8",FedEX항공,156,157,313,0,0,0,3228,3057,6285
"2024","8",GM,2,0,2,0,0,0,3,0,3
"2024","8",KLM네덜란드항공,27,27,54,8752,8877,17629,450,408,858
"2024","8",MY FREIGHTER AIRLINES,1,1,2,0,0,0,0,40,40
"2024","9",가루다인도네시아,51,51,102,10948,10598,21546,175,322,497
"2024","9",그레이터베이항공,33,33,66,3605,4596,8201,19,7,26
"2024","9",내셔널항공,2,2,4,0,0,0,0,188,188
"2024","9",대한항공,3936,3932,7868,664113,673719,1337832,50713,52452,103165
"2024","9",델타항공,148,150,298,33729,38021,71750,130,1234,1364
"2024","9",라오항공,21,21,42,2104,2272,4376,26,4,30
"2024","9",로얄브루나이항공,12,12,24,1073,986,2059,0,4,4
"2024","9",롱하오항공,39,39,78,0,0,0,571,288,859
"2024","9",루프트한자 독일항공,82,81,163,15574,16112,31686,848,1305,2153
"2024","9",말레이시아 항공,30,30,60,7410,7129,14539,284,380,664
"2024","9",몽골항공,65,65,130,14255,11354,25609,32,275,308
"2024","9",미얀마국제항공,15,15,30,1527,1182,2709,5,5,10
"2024","9",미얀마항공,1,1,2,152,16,168,1,1,1
"2024","9",바틱 에어 말레이시아,30,30,60,4683,4119,8802,2,7,9
"2024","9",베트남항공,180,180,360,36861,39245,76106,1167,790,1957
"2024","9",비엣젯항공,448,448,896,76889,66188,143077,428,81,509
"2024","9",사천항공,12,12,24,1741,1524,3265,0,14,14
"2024","9",산동항공,300,299,599,41793,35219,77012,404,32,437
"2024","9",상하이항공,29,29,58,4221,4045,8266,14,1,14
"2024","9",샤먼항공,60,60,120,7137,5424,12561,36,29,65
"2024","9",세부퍼시픽항공,80,80,160,16180,14448,30628,53,209,262
"2024","9",순풍항공,18,17,35,0,0,0,265,34,299
"2024","9",스리랑카항공,9,9,18,1576,1355,2931,118,114,232
"2024","9",스위스 국제항공,13,13,26,2725,2714,5439,130,154,284
"2024","9",스카이 앙코르 항공,14,14,28,1828,2001,3829,4,2,7
"2024","9",스쿠트 항공,34,34,68,10524,10410,20934,112,150,262
"2024","9",실크웨이웨스트항공,8,8,16,0,0,0,471,797,1268
"2024","9",심천항공,65,65,130,8114,7445,15559,72,9,81
"2024","9",싱가포르항공,144,144,288,31446,31100,62546,1418,1676,3094
"2024","9",아메리칸항공,30,30,60,7092,8159,15251,100,283,383
"2024","9",아시아나항공,2327,2323,4650,454701,469888,924589,23418,24322,47741
"2024","9",아에로멕시코,30,30,60,6699,6398,13097,40,222,262
"2024","9",아틀라스항공,177,208,385,0,0,0,2272,1051,3322
"2024","9",에미레이트항공,43,44,87,16074,18403,34477,558,648,1206
"2024","9",에바항공,100,100,200,20752,21444,42196,490,434,924
"2024","9",에어 아스타나,34,34,68,5792,4893,10685,9,111,119
"2024","9",에어 프랑스,30,30,60,9499,9881,19380,441,470,911
"2024","9",에어로 몽골리아,26,26,52,2801,1826,4627,0,0,0
"2024","9",에어로로직,39,40,79,0,0,0,2413,294,2707
"2024","9",에어로케이항공,55,55,110,8081,7935,16016,0,0,0
"2024","9",에어마카오,49,49,98,6299,6040,12339,56,7,64
"2024","9",에어부산,348,347,695,66500,70117,136617,6,22,28
"2024","9",에어서울,396,395,791,71745,73911,145656,75,47,123
"2024","9",에어아시아 버하드,30,30,60,4460,4044,8504,0,0,0
"2024","9",에어아시아엑스,43,43,86,14643,13232,27875,217,333,550
"2024","9",에어인디아 리미티드,17,17,34,3629,3650,7279,76,196,272
"2024","9",에어인천,106,107,213,0,0,0,1536,1325,2861
"2024","9",에어재팬,30,30,60,7000,6498,13498,148,117,264
"2024","9",에어캐나다,73,73,146,20224,21201,41425,278,544,822
"2024","9",에어프레미아,119,120,239,31972,34184,66156,857,1204,2061
"2024","9",에어홍콩,24,24,48,0,0,0,1038,1026,2064
"2024","9",에티오피아항공,63,63,126,4965,4921,9886,967,313,1280
"2024","9",에티하드 항공,48,47,95,12198,12430,24628,556,735,1291
"2024","9",우즈베키스탄항공,30,30,60,7178,7108,14286,28,281,309
"2024","9",원통화물항공,45,45,90,0,0,0,929,408,1337
"2024","9",웨스트젯,13,13,26,4061,4080,8141,10,165,175
"2024","9",유나이티드항공,58,58,116,12671,13666,26337,283,744,1027
"2024","9",유피에스항공,123,125,248,0,0,0,1497,2890,4387
"2024","9",이스타항공,454,454,908,70932,74139,145071,0,0,0
"2024","9",일본항공,19,19,38,0,0,0,340,683,1023
"2024","9",장쑤징동화물항공,12,12,24,0,0,0,206,2,207
"2024","9",전일본공수,24,24,48,0,0,0,717,727,1444
"2024","9",제주항공,1581,1574,3155,244180,248871,493051,886,762,1649
"2024","9",젯스타,30,30,60,9011,8296,17307,28,228,256
"2024","9",중국국제항공,277,277,554,41433,35201,76634,580,128,708
"2024","9",중국남방항공,490,490,980,68365,62688,131053,594,120,714
"2024","9",중국동방항공,591,590,1181,80442,69826,150268,921,477,1398
"2024","9",중국센트럴항공,44,44,88,0,0,0,628,219,846
"2024","9",중국연합항공,5,5,10,802,655,1457,0,0,0
"2024","9",중국우정항공,16,16,32,0,0,0,135,144,279
"2024","9",중국화물항공,12,12,24,0,0,0,1039,560,1600
"2024","9",중화항공,94,94,188,17307,19843,37150,492,543,1034
"2024","9",진에어,929,925,1854,189589,189883,379472,739,828,1568
"2024","9",집에어,30,30,60,7986,7408,15394,224,231,455
"2024","9",천진항공,19,19,38,2657,2089,4746,4,10,14
"2024","9",천진화물항공,42,42,84,0,0,0,647,7,655
"2024","9",청도항공,30,30,60,4499,3701,8200,15,3,18
"2024","9",춘추항공,26,26,52,4223,3673,7896,6,3,9
"2024","9",카고룩스 이탈리아 항공,14,14,28,0,0,0,697,625,1323
"2024","9",카고룩스항공,13,13,26,0,0,0,535,924,1459
"2024","9",카놋샤크,9,9,18,1750,974,2724,0,0,0
"2024","9",카타르항공,49,49,98,12111,12386,24497,1504,1663,3167
"2024","9",칼리타항공,89,91,180,0,0,0,1195,1748,2943
"2024","9",캐세이퍼시픽항공,126,126,252,27523,25822,53345,1105,747,1852
"2024","9",콴타스항공,12,12,24,3509,3023,6532,16,80,96
"2024","9",타이거에어 타이완,30,30,60,4272,3751,8023,4,18,22
"2024","9",타이에어아시아엑스,36,36,72,9748,8737,18485,259,199,458
"2024","9",타이항공,90,90,180,16238,17241,33479,997,599,1596
"2024","9",터키항공,56,56,112,14020,14542,28562,1091,1589,2679
"2024","9",투르크메니스탄,4,4,8,0,0,0,58,174,232
"2024","9",티웨이항공,991,989,1980,173599,177545,351144,804,568,1371
"2024","9",폴라에어카고,58,56,114,0,0,0,1901,1878,3779
"2024","9",폴란드항공,42,42,84,9400,10763,20163,186,377,562
"2024","9",피치항공,152,152,304,22569,21634,44203,0,7,7
"2024","9",핀에어,29,29,58,8379,8910,17289,611,385,996
"2024","9",필리핀에어아시아,30,30,60,4053,3843,7896,3,6,9
"2024","9",필리핀항공,90,88,178,13423,14806,28229,20,155,175
"2024","9",하와이안 항공,22,22,44,4931,5037,9968,28,281,309
"2024","9",홍콩익스프레스,86,86,172,12268,11248,23516,22,10,32
"2024","9",홍콩항공,20,20,40,2823,2512,5335,19,11,30
"2024","9",FedEX항공,146,145,291,0,0,0,2802,2753,5555
"2024","9",KLM네덜란드항공,26,26,52,7733,8106,15839,388,352,740
"2024","9",MY FREIGHTER AIRLINES,1,1,2,0,0,0,1,37,38
"2024","9",ZP,1,1,2,0,0,0,12,0,12
"2024","10",가루다인도네시아,53,53,106,11389,10812,22201,188,365,554
"2024","10",그레이터베이항공,33,33,66,4120,5056,9176,22,14,36
"2024","10",길상항공,7,7,14,672,751,1423,0,0,0
"2024","10",내셔널항공,3,3,6,0,0,0,0,302,302
"2024","10",대한항공,4025,4022,8047,718163,705121,1423284,54342,55900,110242
"2024","10",델타항공,154,157,311,38488,37868,76356,144,1638,1782
"2024","10",라오항공,31,31,62,3481,3538,7019,28,7,35
"2024","10",로얄브루나이항공,14,14,28,1509,1460,2969,5,11,16
"2024","10",롱하오항공,40,40,80,0,0,0,642,415,1057
"2024","10",루프트한자 독일항공,83,83,166,16152,15985,32137,1161,1664,2825
"2024","10",말레이시아 항공,36,36,72,8713,8316,17029,351,472,823
"2024","10",몽골항공,53,54,107,9666,8122,17788,53,263,316
"2024","10",미얀마국제항공,14,14,28,1196,1368,2564,5,5,10
"2024","10",미얀마항공,2,2,4,290,9,299,1,1,2
"2024","10",바틱 에어 말레이시아,31,31,62,4954,3959,8913,1,20,21
"2024","10",베트남항공,186,186,372,38288,41059,79347,1156,962,2118
"2024","10",비엣젯항공,462,462,924,83841,72836,156677,496,121,617
"2024","10",사천항공,14,14,28,1963,1965,3928,1,15,16
"2024","10",산동항공,289,291,580,37390,39294,76684,473,25,499
"2024","10",상하이항공,32,32,64,4428,4616,9044,20,0,20
"2024","10",샤먼항공,61,61,122,5675,5477,11152,48,25,73
"2024","10",세부퍼시픽항공,89,89,178,18878,15522,34400,60,210,270
"2024","10",순풍항공,16,17,33,0,0,0,231,92,323
"2024","10",스리랑카항공,9,8,17,1393,1225,2618,94,93,187
"2024","10",스위스 국제항공,10,10,20,2116,2016,4132,82,125,206
"2024","10",스카이 앙코르 항공,15,15,30,2001,1622,3623,3,3,6
"2024","10",스쿠트 항공,35,35,70,11883,10966,22849,111,186,298
"2024","10",실크웨이웨스트항공,9,9,18,0,0,0,492,809,1301
"2024","10",심천항공,66,66,132,8658,8490,17148,91,7,98
"2024","10",싱가포르항공,151,152,303,38614,38139,76753,1506,2224,3730
"2024","10",아메리칸항공,31,31,62,8312,8649,16961,109,322,431
"2024","10",아시아나항공,2420,2417,4837,504314,503383,1007697,25263,26136,51399
"2024","10",아에로멕시코,31,31,62,6822,6548,13370,37,251,288
"2024","10",아틀라스항공,167,187,354,0,0,0,2938,853,3791
"2024","10",안토노프항공,0,1,1,0,0,0,0,42,42
"2024","10",에미레이트항공,44,43,87,19098,17948,37046,470,583,1053
"2024","10",에바항공,94,94,188,23404,22930,46334,573,571,1144
"2024","10",에어 뉴질랜드,1,1,2,236,236,472,0,14,15
"2024","10",에어 아스타나,31,31,62,5193,4580,9773,12,126,138
"2024","10",에어 프랑스,31,31,62,10562,9375,19937,425,443,869
"2024","10",에어로 몽골리아,21,21,42,2132,1971,4103,0,0,0
"2024","10",에어로로직,39,39,78,0,0,0,2509,242,2751
"2024","10",에어로케이항공,59,57,116,9045,8224,17269,0,0,0
"2024","10",에어마카오,62,62,124,8028,8428,16456,75,13,88
"2024","10",에어부산,359,359,718,74312,72720,147032,8,14,22
"2024","10",에어서울,408,408,816,77567,77155,154722,94,8,102
"2024","10",에어아시아 버하드,29,28,57,3736,3212,6948,0,0,0
"2024","10",에어아시아엑스,45,45,90,15693,12999,28692,168,314,482
"2024","10",에어인디아 리미티드,18,18,36,3887,4197,8084,73,195,268
"2024","10",에어인천,124,124,248,0,0,0,1685,1578,3263
"2024","10",에어재팬,31,31,62,8513,6192,14705,173,119,292
"2024","10",에어캐나다,73,73,146,21785,20774,42559,346,665,1011
"2024","10",에어프레미아,121,121,242,32872,31990,64862,840,1297,2137
"2024","10",에어홍콩,26,26,52,0,0,0,1074,1109,2183
"2024","10",에티오피아항공,66,66,132,5702,4850,10552,1145,430,1575
"2024","10",에티하드 항공,48,49,97,13130,12352,25482,547,805,1352
"2024","10",우즈베키스탄항공,30,30,60,7456,6928,14384,33,300,333
"2024","10",원통화물항공,43,43,86,0,0,0,938,581,1519
"2024","10",웨스트젯,13,13,26,4133,4092,8225,2,160,162
"2024","10",유나이티드항공,62,62,124,15241,13856,29097,271,918,1189
"2024","10",유피에스항공,129,129,258,0,0,0,1441,2878,4319
"2024","10",이스타항공,511,502,1013,83167,81358,164525,0,0,0
"2024","10",일본항공,21,21,42,0,0,0,359,709,1069
"2024","10",장쑤징동화물항공,13,13,26,0,0,0,210,3,214
"2024","10",전일본공수,27,27,54,0,0,0,776,830,1606
"2024","10",제주항공,1660,1658,3318,265115,258503,523618,1084,951,2034
"2024","10",젯스타,31,30,61,8670,8882,17552,72,247,319
"2024","10",중국국제항공,286,286,572,35109,37932,73041,206,109,315
"2024","10",중국남방항공,466,466,932,60288,65545,125833,557,125,682
"2024","10",중국동방항공,559,560,1119,69755,73315,143070,1121,477,1599
"2024","10",중국센트럴항공,44,44,88,0,0,0,623,268,891
"2024","10",중국우정항공,12,12,24,0,0,0,159,134,293
"2024","10",중국해남항공,1,1,2,36,19,55,2,0,2
"2024","10",중국화물항공,12,12,24,0,0,0,1082,478,1559
"2024","10",중화항공,93,91,184,21399,21314,42713,563,540,1103
"2024","10",진에어,976,972,1948,214747,209676,424423,892,887,1779
"2024","10",집에어,31,31,62,8397,7774,16171,237,232,468
"2024","10",천진항공,17,17,34,1630,1655,3285,2,4,6
"2024","10",천진화물항공,22,22,44,0,0,0,362,27,389
"2024","10",청도항공,31,31,62,4533,4474,9007,22,4,26
"2024","10",춘추항공,27,27,54,3960,4049,8009,5,3,8
"2024","10",카고룩스 이탈리아 항공,13,13,26,0,0,0,774,573,1347
"2024","10",카고룩스항공,13,13,26,0,0,0,413,902,1315
"2024","10",카놋샤크,9,9,18,1312,603,1915,0,14,14
"2024","10",카타르항공,53,52,105,12972,12402,25374,1246,1973,3219
"2024","10",칼리타항공,93,92,185,0,0,0,1635,1585,3220
"2024","10",캐세이퍼시픽항공,137,136,273,33298,35417,68715,1422,773,2195
"2024","10",콴타스항공,15,15,30,4151,4217,8368,43,115,158
"2024","10",타이거에어 타이완,30,31,61,5118,4231,9349,5,20,24
"2024","10",타이에어아시아엑스,60,59,119,15055,13244,28299,117,24,141
"2024","10",타이항공,93,93,186,23847,24200,48047,923,868,1791
"2024","10",터키항공,56,55,111,16498,14326,30824,1048,1588,2636
"2024","10",투르크메니스탄,4,4,8,0,0,0,74,177,252
"2024","10",티웨이항공,1062,1060,2122,192126,184078,376204,824,654,1477
"2024","10",폴라에어카고,56,57,113,0,0,0,1693,1902,3594
"2024","10",폴란드항공,42,42,84,10667,8866,19533,156,442,599
"2024","10",피치항공,156,156,312,25464,23199,48663,0,10,10
"2024","10",핀에어,31,31,62,9589,8649,18238,610,436,1045
"2024","10",필리핀에어아시아,33,32,65,5059,4175,9234,3,8,11
"2024","10",필리핀항공,80,80,160,14560,14303,28863,20,216,236
"2024","10",하와이안 항공,21,21,42,5177,5227,10404,26,317,343
"2024","10",홍콩익스프레스,93,93,186,16477,16726,33203,20,26,47
"2024","10",홍콩항공,25,25,50,3796,3733,7529,19,8,26
"2024","10",FedEX항공,157,158,315,0,0,0,2941,3225,6166
"2024","10",KLM네덜란드항공,24,24,48,7785,7458,15243,404,361,765
"2024","10",MY FREIGHTER AIRLINES,2,3,5,0,0,0,4,137,141
"2024","11",가루다인도네시아,55,55,110,10821,10495,21316,178,544,721
"2024","11",그레이터베이항공,29,29,58,3791,4573,8364,27,23,49
"2024","11",길상항공,9,9,18,906,815,1721,0,0,0
"2024","11",내셔널항공,1,1,2,0,0,0,0,100,100
"2024","11",대한항공,3831,3839,7670,683019,701614,1384633,52396,55373,107769
"2024","11",델타항공,151,152,303,35610,37475,73085,150,1447,1597
"2024","11",라오항공,31,30,61,3454,3931,7385,33,6,39
"2024","11",로얄브루나이항공,13,13,26,1135,1314,2449,5,12,17
"2024","11",롱하오항공,38,38,76,0,0,0,598,413,1010
"2024","11",루프트한자 독일항공,81,81,162,13543,14908,28451,958,1359,2317
"2024","11",말레이시아 항공,34,34,68,6998,8016,15014,355,537,892
"2024","11",몽골항공,52,51,103,7896,8700,16596,58,239,297
"2024","11",미얀마국제항공,14,14,28,1187,1379,2566,4,6,10
"2024","11",미얀마항공,5,5,10,696,17,713,2,2,4
"2024","11",바틱 에어 말레이시아,30,30,60,4151,4121,8272,1,43,44
"2024","11",베트남항공,180,180,360,36627,43491,80118,1108,906,2014
"2024","11",비엣젯항공,450,452,902,83110,86207,169317,465,90,555
"2024","11",사천항공,13,13,26,2083,1976,4059,0,12,12
"2024","11",산동항공,243,243,486,33696,33270,66966,385,18,402
"2024","11",상하이항공,29,29,58,4201,4508,8709,19,1,20
"2024","11",샤먼항공,59,59,118,6058,5219,11277,47,28,75
"2024","11",세부퍼시픽항공,90,90,180,21220,21941,43161,120,368,488
"2024","11",순풍항공,21,21,42,0,0,0,335,57,392
"2024","11",스리랑카항공,7,7,14,1342,1408,2750,45,82,126
"2024","11",스카이 앙코르 항공,20,20,40,2154,3109,5263,7,4,11
"2024","11",스쿠트 항공,30,30,60,9776,9498,19274,86,194,280
"2024","11",실크웨이웨스트항공,10,10,20,0,0,0,555,1149,1704
"2024","11",심천항공,59,59,118,8213,8087,16300,84,6,90
"2024","11",싱가포르항공,145,145,290,35825,36907,72732,1234,2012,3246
"2024","11",아메리칸항공,30,30,60,6868,7882,14750,82,269,350
"2024","11",아시아나항공,2383,2388,4771,478255,500044,978299,26907,29477,56384
"2024","11",아에로멕시코,30,29,59,5355,6354,11709,16,263,279
"2024","11",아틀라스항공,211,207,418,0,0,0,2715,583,3299
"2024","11",에미레이트항공,43,43,86,14965,15785,30750,507,642,1148
"2024","11",에바항공,88,88,176,20782,21311,42093,700,551,1252
"2024","11",에어 뉴질랜드,13,12,25,2601,2692,5293,76,173,250
"2024","11",에어 아스타나,30,30,60,3770,3999,7769,10,136,146
"2024","11",에어 프랑스,30,30,60,7746,7545,15291,328,344,671
"2024","11",에어로 몽골리아,12,12,24,897,1177,2074,0,0,0
"2024","11",에어로로직,43,43,86,0,0,0,2186,361,2548
"2024","11",에어로케이항공,47,47,94,6942,7376,14318,0,0,0
"2024","11",에어마카오,60,60,120,9097,9216,18313,73,5,78
"2024","11",에어부산,338,338,676,69936,73068,143004,2,23,25
"2024","11",에어서울,387,386,773,74375,75924,150299,82,43,125
"2024","11",에어아시아 버하드,21,22,43,2239,2772,5011,0,0,0
"2024","11",에어아시아엑스,52,52,104,17427,17043,34470,254,340,594
"2024","11",에어인디아 리미티드,15,15,30,3548,3789,7337,113,158,271
"2024","11",에어인천,146,145,291,0,0,0,2077,1749,3826
"2024","11",에어재팬,29,29,58,7900,6578,14478,135,134,270
"2024","11",에어캐나다,60,60,120,16982,17438,34420,416,503,919
"2024","11",에어프레미아,115,114,229,28582,29617,58199,745,1321,2066
"2024","11",에어홍콩,26,26,52,0,0,0,1102,1122,2223
"2024","11",에티오피아항공,63,64,127,5403,5229,10632,1010,477,1487
"2024","11",에티하드 항공,47,47,94,9919,9718,19637,566,723,1288
"2024","11",우즈베키스탄항공,30,30,60,6241,6378,12619,44,324,368
"2024","11",원통화물항공,51,51,102,0,0,0,1168,562,1730
"2024","11",유나이티드항공,60,60,120,13103,13049,26152,270,1011,1280
"2024","11",유피에스항공,122,120,242,0,0,0,1518,2910,4428
"2024","11",이스타항공,526,524,1050,87746,89566,177312,0,0,0
"2024","11",일본항공,22,22,44,0,0,0,367,776,1143
"2024","11",장쑤징동화물항공,13,13,26,0,0,0,219,3,222
"2024","11",전일본공수,26,26,52,0,0,0,792,871,1663
"2024","11",제주항공,1528,1525,3053,244468,253548,498016,1044,905,1948
"2024","11",젯스타,30,31,61,9202,9297,18499,78,308,386
"2024","11",중국국제항공,212,212,424,26723,27255,53978,72,92,163
"2024","11",중국남방항공,412,412,824,51855,55152,107007,519,121,640
"2024","11",중국동방항공,439,440,879,61091,60246,121337,969,468,1437
"2024","11",중국센트럴항공,51,51,102,0,0,0,717,307,1024
"2024","11",중국우정항공,24,24,48,0,0,0,296,135,431
"2024","11",중국해남항공,6,6,12,375,410,785,5,0,5
"2024","11",중국화물항공,13,13,26,0,0,0,1183,616,1799
"2024","11",중화항공,90,91,181,20782,21697,42479,511,594,1105
"2024","11",진에어,903,903,1806,198884,202870,401754,866,1018,1883
"2024","11",집에어,30,30,60,8186,7798,15984,245,215,460
"2024","11",천진항공,15,15,30,1376,1387,2763,0,0,0
"2024","11",천진화물항공,34,34,68,0,0,0,561,26,587
"2024","11",청도항공,28,28,56,4045,4048,8093,29,3,32
"2024","11",춘추항공,25,25,50,3610,3778,7388,11,3,14
"2024","11",카고룩스 이탈리아 항공,12,12,24,0,0,0,726,585,1311
"2024","11",카고룩스항공,13,13,26,0,0,0,703,935,1638
"2024","11",카놋샤크,8,8,16,474,520,994,0,22,22
"2024","11",카타르항공,53,53,106,10732,12272,23004,1415,2213,3628
"2024","11",칼리타항공,111,112,223,0,0,0,1539,1961,3499
"2024","11",캐세이퍼시픽항공,109,110,219,30582,31579,62161,1356,761,2118
"2024","11",콴타스항공,17,16,33,4541,4395,8936,54,140,194
"2024","11",타이거에어 타이완,30,29,59,5003,4361,9364,10,29,38
"2024","11",타이에어아시아엑스,55,56,111,13964,16828,30792,52,18,71
"2024","11",타이항공,90,90,180,24056,27813,51869,803,919,1722
"2024","11",터키항공,56,56,112,15243,14068,29311,1386,1661,3047
"2024","11",투르크메니스탄,5,5,10,0,0,0,89,230,319
"2024","11",티웨이항공,990,990,1980,182280,183266,365546,1088,632,1720
"2024","11",폴라에어카고,55,56,111,0,0,0,1847,1879,3727
"2024","11",폴란드항공,29,29,58,5412,6033,11445,196,283,479
"2024","11",피치항공,147,147,294,25342,24417,49759,0,10,10
"2024","11",핀에어,30,30,60,6435,7036,13471,631,436,1067
"2024","11",필리핀에어아시아,43,44,87,5408,7149,12557,5,13,18
"2024","11",필리핀항공,60,60,120,12496,14842,27338,21,252,272
"2024","11",하와이안 항공,22,22,44,4311,5119,9430,24,349,373
"2024","11",홍콩익스프레스,69,69,138,13263,13282,26545,18,21,39
"2024","11",홍콩항공,19,19,38,2968,2806,5774,18,1,20
"2024","11",FedEX항공,155,156,311,0,0,0,3386,3227,6613
"2024","11",KLM네덜란드항공,21,21,42,5628,5962,11590,343,296,639
"2024","11",MY FREIGHTER AIRLINES,6,6,12,0,0,0,3,253,256
"2024","12",가루다인도네시아,62,62,124,12653,12333,24986,189,584,774
"2024","12",그레이터베이항공,30,30,60,4546,4537,9083,36,32,68
"2024","12",길상항공,3,3,6,216,201,417,0,0,0
"2024","12",대한항공,4197,4181,8378,767011,769750,1536761,53493,55283,108776
"2024","12",델타항공,154,157,311,38899,36142,75041,177,1577,1755
"2024","12",라오항공,32,32,64,3808,3708,7516,19,8,27
"2024","12",로얄브루나이항공,13,13,26,1032,1041,2073,0,15,15
"2024","12",롱하오항공,61,61,122,0,0,0,840,547,1387
"2024","12",루프트한자 독일항공,68,69,137,12858,11644,24502,808,1051,1859
"2024","12",말레이시아 항공,32,32,64,7051,7477,14528,335,514,849
"2024","12",몽골항공,54,55,109,9761,8380,18141,73,280,354
"2024","12",미얀마국제항공,18,18,36,2098,1982,4080,3,5,8
"2024","12",미얀마항공,1,1,2,142,16,158,1,1,2
"2024","12",바틱 에어 말레이시아,31,31,62,4650,4481,9131,0,35,35
"2024","12",뱀부 항공,1,1,2,188,0,188,0,0,0
"2024","12",베트남항공,186,186,372,41118,46576,87694,939,806,1745
"2024","12",비엣젯항공,465,465,930,89824,92390,182214,437,128,565
"2024","12",사천항공,13,13,26,1854,1936,3790,0,7,7
"2024","12",산동항공,262,262,524,27805,36089,63894,428,16,444
"2024","12",상하이항공,31,31,62,4642,4904,9546,12,2,14
"2024","12",샤먼항공,61,61,122,6464,6960,13424,53,18,71
"2024","12",세부퍼시픽항공,93,93,186,21809,23351,45160,80,332,412
"2024","12",순풍항공,22,21,43,0,0,0,482,40,522
"2024","12",스리랑카항공,9,9,18,1600,2305,3905,32,108,140
"2024","12",스카이 앙코르 항공,29,29,58,3583,4499,8082,7,6,12
"2024","12",스쿠트 항공,40,40,80,13173,12791,25964,88,267,355
"2024","12",실크웨이웨스트항공,10,10,20,0,0,0,662,1027,1689
"2024","12",심천항공,63,63,126,8538,8725,17263,72,4,76
"2024","12",싱가포르항공,148,148,296,36203,38062,74265,1216,1925,3141
"2024","12",아메리칸항공,31,31,62,7545,7609,15154,51,301,352
"2024","12",아시아나항공,2565,2555,5120,519275,534593,1053868,26544,29024,55568
"2024","12",아에로멕시코,30,31,61,5302,5869,11171,22,282,304
"2024","12",아틀라스항공,199,212,411,0,0,0,2562,799,3360
"2024","12",에미레이트항공,44,44,88,12768,14853,27621,542,687,1229
"2024","12",에바항공,93,93,186,21883,22299,44182,754,553,1307
"2024","12",에어 뉴질랜드,13,14,27,3571,3261,6832,83,170,253
"2024","12",에어 아스타나,34,34,68,3274,4155,7429,6,83,89
"2024","12",에어 프랑스,27,27,54,7068,6561,13629,298,416,714
"2024","12",에어로 몽골리아,13,13,26,1391,982,2373,0,0,0
"2024","12",에어로로직,42,42,84,0,0,0,2459,324,2783
"2024","12",에어로케이항공,69,70,139,10640,10530,21170,0,0,0
"2024","12",에어마카오,61,61,122,9088,9063,18151,66,5,71
"2024","12",에어부산,360,358,718,77116,77308,154424,3,17,21
"2024","12",에어서울,400,402,802,77229,77853,155082,90,22,111
"2024","12",에어아시아 버하드,30,30,60,4491,4530,9021,0,0,0
"2024","12",에어아시아엑스,53,53,106,16620,15863,32483,243,376,619
"2024","12",에어인디아 리미티드,18,18,36,4185,4242,8427,96,184,280
"2024","12",에어인천,136,137,273,0,0,0,1790,1739,3529
"2024","12",에어재팬,31,31,62,7770,6456,14226,157,110,266
"2024","12",에어캐나다,61,60,121,17419,16222,33641,415,432,848
"2024","12",에어프레미아,121,122,243,32141,31980,64121,698,1352,2050
"2024","12",에어홍콩,26,26,52,0,0,0,1069,1194,2263
"2024","12",에티오피아항공,66,66,132,4973,4352,9325,1189,446,1635
"2024","12",에티하드 항공,49,49,98,8006,8664,16670,668,717,1386
"2024","12",우즈베키스탄항공,31,31,62,5646,6778,12424,52,273,324
"2024","12",원통화물항공,44,44,88,0,0,0,1051,421,1472
"2024","12",유나이티드항공,62,62,124,14763,13249,28012,306,1066,1372
"2024","12",유피에스항공,124,125,249,0,0,0,1474,2776,4249
"2024","12",이스타항공,556,553,1109,94559,95905,190464,0,0,0
"2024","12",일본항공,21,21,42,0,0,0,379,754,1133
"2024","12",장쑤징동화물항공,44,44,88,0,0,0,693,133,826
"2024","12",전일본공수,26,26,52,0,0,0,722,878,1601
"2024","12",제주항공,1648,1645,3293,269946,272481,542427,1027,931,1958
"2024","12",젯스타,31,31,62,9965,9072,19037,72,260,333
"2024","12",중국국제항공,214,214,428,24752,29144,53896,62,92,154
"2024","12",중국남방항공,431,431,862,55350,65791,121141,514,123,638
"2024","12",중국동방항공,539,538,1077,68052,77503,145555,1008,478,1486
"2024","12",중국센트럴항공,19,19,38,0,0,0,207,151,358
"2024","12",중국우정항공,29,29,58,0,0,0,382,150,532
"2024","12",중국해남항공,11,11,22,1353,1393,2746,3,0,3
"2024","12",중국화물항공,15,15,30,0,0,0,1299,550,1849
"2024","12",중화항공,93,93,186,21594,22128,43722,597,595,1192
"2024","12",진에어,1046,1045,2091,224305,228401,452706,856,995,1851
"2024","12",집에어,31,31,62,8154,7589,15743,249,184,433
"2024","12",천진항공,13,13,26,1129,1303,2432,0,0,0
"2024","12",천진화물항공,28,28,56,0,0,0,448,12,460
"2024","12",청도항공,30,30,60,3130,4574,7704,19,4,24
"2024","12",춘추항공,27,27,54,3885,4267,8152,6,4,10
"2024","12",카고룩스 이탈리아 항공,14,14,28,0,0,0,956,648,1604
"2024","12",카고룩스항공,13,13,26,0,0,0,725,974,1699
"2024","12",카놋샤크,9,9,18,541,968,1509,0,19,19
"2024","12",카타르항공,51,52,103,9543,10573,20116,1385,2005,3390
"2024","12",칼리타항공,111,111,222,0,0,0,1562,1923,3485
"2024","12",캐세이퍼시픽항공,125,125,250,32016,31793,63809,1270,831,2101
"2024","12",콴타스항공,18,19,37,5195,4298,9493,21,153,174
"2024","12",타이거에어 타이완,31,31,62,5244,4720,9964,3,29,32
"2024","12",타이에어아시아엑스,45,45,90,13429,14591,28020,104,11,116
"2024","12",타이항공,93,92,185,27491,28651,56142,809,745,1554
"2024","12",터키항공,57,57,114,13897,12143,26040,1456,1662,3117
"2024","12",투르크메니스탄,4,4,8,0,0,0,51,169,220
"2024","12",티웨이항공,1077,1075,2152,209369,208050,417419,1104,936,2039
"2024","12",폴라에어카고,68,68,136,0,0,0,2153,1612,3765
"2024","12",폴란드항공,21,20,41,4557,3935,8492,162,178,340
"2024","12",피치항공,155,154,309,25769,25003,50772,0,8,8
"2024","12",핀에어,22,22,44,5381,5059,10440,437,278,715
"2024","12",필리핀에어아시아,44,44,88,6029,7298,13327,4,12,16
"2024","12",필리핀항공,73,73,146,14217,18761,32978,23,226,248
"2024","12",하와이안 항공,22,22,44,5080,5262,10342,16,284,300
"2024","12",홍콩익스프레스,93,93,186,19957,18919,38876,28,35,63
"2024","12",홍콩항공,49,49,98,8331,7823,16154,27,0,27
"2024","12",FedEX항공,153,153,306,0,0,0,3133,3177,6311
"2024","12",GM,1,0,1,0,0,0,1,0,1
"2024","12",KLM네덜란드항공,20,20,40,5387,5379,10766,289,280,569
"2024","12",MY FREIGHTER AIRLINES,4,4,8,0,0,0,1,162,163
"2024","12",ZP,1,1,2,0,0,0,0,7,7
"2025","1",가루다인도네시아,60,60,120,11435,14392,25827,160,318,478
"2025","1",그레이터베이항공,31,31,62,4768,4539,9307,29,21,50
"2025","1",대한항공,4237,4245,8482,768281,820529,1588810,48804,50531,99335
"2025","1",델타항공,154,154,308,35575,40978,76553,135,1408,1543
"2025","1",라오항공,31,31,62,3398,3517,6915,11,5,15
"2025","1",로얄브루나이항공,13,13,26,1183,1427,2610,2,7,8
"2025","1",롱하오항공,47,47,94,0,0,0,701,362,1063
"2025","1",루프트한자 독일항공,55,55,110,11577,13359,24936,514,602,1116
"2025","1",말레이시아 항공,50,49,99,8976,12198,21174,322,481,803
"2025","1",몽골항공,57,56,113,7785,9658,17443,24,149,173
"2025","1",미얀마국제항공,18,18,36,2008,2053,4061,2,0,2
"2025","1",미얀마항공,1,1,2,144,38,182,1,1,2
"2025","1",바틱 에어 말레이시아,31,31,62,4358,5028,9386,2,21,23
"2025","1",뱀부 항공,1,1,2,188,0,188,0,0,0
"2025","1",베트남항공,186,186,372,40579,47602,88181,960,722,1682
"2025","1",비엣젯항공,465,465,930,87430,91004,178434,374,116,491
"2025","1",사천항공,12,12,24,1748,1732,3480,0,5,5
"2025","1",산동항공,259,259,518,31831,35064,66895,303,18,321
"2025","1",상하이항공,31,31,62,4707,4588,9295,15,0,15
"2025","1",샤먼항공,44,44,88,5345,5344,10689,28,14,42
"2025","1",세부퍼시픽항공,93,93,186,22795,24489,47284,66,221,287
"2025","1",순풍항공,17,18,35,0,0,0,237,56,293
"2025","1",스리랑카항공,10,10,20,2256,2767,5023,43,123,167
"2025","1",스카이 앙코르 항공,46,46,92,6167,7491,13658,5,7,12
"2025","1",스쿠트 항공,34,33,67,10155,10630,20785,73,152,225
"2025","1",실크웨이웨스트항공,7,7,14,0,0,0,355,695,1050
"2025","1",심천항공,68,68,136,9627,8550,18177,69,6,75
"2025","1",싱가포르항공,139,138,277,27382,34303,61685,1228,1708,2936
"2025","1",아메리칸항공,29,29,58,6348,7722,14070,28,247,275
"2025","1",아시아나항공,2585,2591,5176,521898,560389,1082287,23412,23330,46742
"2025","1",아에로멕시코,30,30,60,4385,5833,10218,18,241,258
"2025","1",아틀라스항공,199,212,411,0,0,0,1661,805,2466
"2025","1",에미레이트항공,45,45,90,15102,17452,32554,420,649,1069
"2025","1",에바항공,111,111,222,24556,24224,48780,704,413,1116
"2025","1",에어 뉴질랜드,12,12,24,2824,3553,6377,3,112,115
"2025","1",에어 아스타나,30,30,60,3490,4039,7529,10,82,93
"2025","1",에어 프랑스,29,29,58,7213,7975,15188,239,310,550
"2025","1",에어로 몽골리아,16,16,32,1737,2127,3864,0,0,0
"2025","1",에어로로직,35,35,70,0,0,0,2041,273,2315
"2025","1",에어로케이항공,101,97,198,13154,14133,27287,0,0,0
"2025","1",에어마카오,64,64,128,8317,8478,16795,44,3,47
"2025","1",에어부산,359,359,718,73227,77360,150587,5,11,17
"2025","1",에어서울,409,409,818,75555,79964,155519,82,16,98
"2025","1",에어아시아 버하드,31,31,62,4627,4599,9226,0,0,0
"2025","1",에어아시아엑스,53,53,106,16533,18196,34729,201,300,501
"2025","1",에어인디아 리미티드,17,17,34,3726,4131,7857,77,167,244
"2025","1",에어인천,95,94,189,0,0,0,1420,1044,2463
"2025","1",에어재팬,30,30,60,6652,8338,14990,141,77,219
"2025","1",에어캐나다,60,61,121,14848,17448,32296,271,371,641
"2025","1",에어프레미아,133,132,265,31260,38645,69905,590,1172,1762
"2025","1",에어홍콩,25,25,50,0,0,0,941,1027,1968
"2025","1",에티오피아항공,66,65,131,4673,5359,10032,876,312,1189
"2025","1",에티하드 항공,49,48,97,9753,11860,21613,446,565,1011
"2025","1",우즈베키스탄항공,30,30,60,6339,6561,12900,23,163,186
"2025","1",원통화물항공,23,23,46,0,0,0,550,127,678
"2025","1",유나이티드항공,56,56,112,11932,14358,26290,321,861,1181
"2025","1",유피에스항공,121,121,242,0,0,0,1349,2213,3563
"2025","1",이스타항공,572,573,1145,93743,99210,192953,7,2,9
"2025","1",일본항공,17,17,34,0,0,0,289,572,861
"2025","1",장쑤징동화물항공,39,39,78,0,0,0,593,129,722
"2025","1",전일본공수,24,24,48,0,0,0,520,722,1242
"2025","1",제주항공,1674,1672,3346,217303,239495,456798,914,700,1614
"2025","1",젯스타,31,31,62,9028,10046,19074,27,225,251
"2025","1",중국국제항공,255,255,510,33679,33784,67463,63,61,124
"2025","1",중국남방항공,489,489,978,64837,71471,136308,434,83,517
"2025","1",중국동방항공,576,576,1152,73785,80081,153866,1053,444,1497
"2025","1",중국센트럴항공,17,17,34,0,0,0,221,67,288
"2025","1",중국우정항공,30,30,60,0,0,0,371,134,505
"2025","1",중국해남항공,18,18,36,2359,2360,4719,3,0,3
"2025","1",중국화물항공,13,13,26,0,0,0,1093,449,1542
"2025","1",중화항공,97,97,194,22192,22062,44254,452,543,995
"2025","1",진에어,1157,1157,2314,233772,244154,477926,634,776,1410
"2025","1",집에어,31,31,62,7630,8045,15675,220,227,448
"2025","1",천진항공,14,14,28,1210,1286,2496,0,0,0
"2025","1",천진화물항공,28,28,56,0,0,0,448,4,451
"2025","1",청도항공,30,30,60,4520,4646,9166,33,3,37
"2025","1",춘추항공,29,29,58,4588,4587,9175,6,2,8
"2025","1",카고룩스 이탈리아 항공,13,13,26,0,0,0,446,557,1004
"2025","1",카고룩스항공,12,12,24,0,0,0,441,872,1313
"2025","1",카놋샤크,9,9,18,832,1132,1964,0,18,18
"2025","1",카타르항공,51,51,102,10429,13262,23691,1187,1567,2754
"2025","1",칼리타항공,94,93,187,0,0,0,1221,1424,2644
"2025","1",캐세이퍼시픽항공,131,131,262,31106,32690,63796,1087,748,1835
"2025","1",콴타스항공,17,17,34,3757,5025,8782,14,68,81
"2025","1",타이거에어 타이완,31,31,62,5245,4270,9515,6,22,28
"2025","1",타이에어아시아엑스,42,42,84,11765,13483,25248,136,54,190
"2025","1",타이항공,93,94,187,26056,29282,55338,597,723,1320
"2025","1",터키항공,57,57,114,12798,14736,27534,1062,1509,2571
"2025","1",투르크메니스탄,4,4,8,0,0,0,17,164,181
"2025","1",티웨이항공,1117,1115,2232,204148,219363,423511,747,555,1302
"2025","1",폴라에어카고,41,41,82,0,0,0,1345,1139,2484
"2025","1",폴란드항공,29,29,58,5248,6399,11647,159,235,394
"2025","1",피치항공,155,156,311,24376,26106,50482,0,7,7
"2025","1",핀에어,27,27,54,5828,7039,12867,531,347,877
"2025","1",필리핀에어아시아,44,44,88,6073,7214,13287,7,9,16
"2025","1",필리핀항공,153,153,306,27104,32415,59519,25,168,193
"2025","1",하와이안 항공,22,21,43,4400,5694,10094,14,251,266
"2025","1",홍콩익스프레스,93,93,186,19824,20306,40130,28,12,39
"2025","1",홍콩항공,60,60,120,9988,11150,21138,27,16,43
"2025","1",FedEX항공,147,146,293,0,0,0,3003,3056,6059
"2025","1",KLM네덜란드항공,22,22,44,5464,6186,11650,225,267,492
"2025","2",가루다인도네시아,52,52,104,11895,10865,22760,168,330,498
"2025","2",그레이터베이항공,20,20,40,2493,2768,5261,15,9,24
"2025","2",내셔널항공,1,1,2,0,0,0,3,102,106
"2025","2",대한항공,3752,3749,7501,735464,703531,1438995,46166,45197,91362
"2025","2",델타항공,140,140,280,34181,30897,65078,124,1313,1437
"2025","2",라오항공,28,28,56,3490,3153,6643,9,6,14
"2025","2",로얄브루나이항공,12,12,24,1478,1504,2982,0,2,2
"2025","2",롱하오항공,39,39,78,0,0,0,598,411,1009
"2025","2",루프트한자 독일항공,62,60,122,12192,9230,21422,662,790,1452
"2025","2",말레이시아 항공,48,48,96,11016,10270,21286,332,434,765
"2025","2",몽골항공,43,43,86,6505,7643,14148,61,183,245
"2025","2",미얀마국제항공,16,16,32,2003,1693,3696,2,1,3
"2025","2",미얀마항공,2,2,4,295,14,309,1,0,2
"2025","2",바틱 에어 말레이시아,28,28,56,4693,4377,9070,1,16,16
"2025","2",베트남항공,168,168,336,41865,38991,80856,826,829,1655
"2025","2",비엣젯항공,420,420,840,86502,75434,161936,294,98,392
"2025","2",사천항공,12,12,24,1826,1736,3562,1,7,8
"2025","2",산동항공,246,247,493,35559,32336,67895,277,10,287
"2025","2",상하이항공,28,28,56,3997,4289,8286,5,0,5
"2025","2",샤먼항공,34,34,68,5104,4398,9502,14,14,28
"2025","2",세부퍼시픽항공,84,84,168,22026,18712,40738,65,223,288
"2025","2",순풍항공,17,16,33,0,0,0,226,49,275
"2025","2",스리랑카항공,8,8,16,2218,1837,4055,76,91,167
"2025","2",스카이 앙코르 항공,52,52,104,8195,6964,15159,1,7,9
"2025","2",스쿠트 항공,36,37,73,11378,11781,23159,116,193,309
"2025","2",실크웨이웨스트항공,7,7,14,0,0,0,578,606,1183
"2025","2",심천항공,60,60,120,8132,8558,16690,53,7,60
"2025","2",싱가포르항공,124,124,248,29836,28577,58413,1548,1512,3060
"2025","2",아메리칸항공,28,28,56,7110,6924,14034,22,255,277
"2025","2",아시아나항공,2330,2328,4658,497113,471540,968653,23388,21211,44599
"2025","2",아에로멕시코,28,28,56,4826,4428,9254,23,217,239
"2025","2",아틀라스항공,132,142,274,0,0,0,1939,560,2499
"2025","2",에미레이트항공,40,40,80,14037,12798,26835,531,379,910
"2025","2",에바항공,100,100,200,22949,23731,46680,619,426,1045
"2025","2",에어 뉴질랜드,11,11,22,2758,2875,5633,4,35,39
"2025","2",에어 아스타나,24,24,48,4230,3009,7239,8,96,104
"2025","2",에어 프랑스,22,22,44,6254,5171,11425,249,281,530
"2025","2",에어로 몽골리아,12,12,24,1242,1587,2829,0,0,0
"2025","2",에어로로직,36,36,72,0,0,0,2175,244,2419
"2025","2",에어로케이항공,91,84,175,14433,12084,26517,0,0,0
"2025","2",에어마카오,53,53,106,6463,7023,13486,22,5,27
"2025","2",에어부산,321,321,642,68985,66521,135506,20,14,35
"2025","2",에어서울,369,368,737,73288,70307,143595,83,27,109
"2025","2",에어아시아 버하드,28,28,56,4328,4115,8443,0,0,0
"2025","2",에어아시아엑스,48,48,96,16460,15380,31840,158,313,471
"2025","2",에어인디아 리미티드,16,16,32,3950,2866,6816,101,154,254
"2025","2",에어인천,109,110,219,0,0,0,1582,1334,2916
"2025","2",에어재팬,28,28,56,8718,6961,15679,133,83,216
"2025","2",에어캐나다,49,48,97,13270,12762,26032,323,277,600
"2025","2",에어프레미아,130,131,261,37249,34423,71672,1029,833,1861
"2025","2",에어홍콩,24,24,48,0,0,0,918,1058,1976
"2025","2",에티오피아항공,59,59,118,6067,4018,10085,1054,271,1326
"2025","2",에티하드 항공,44,44,88,11016,8205,19221,545,434,980
"2025","2",우즈베키스탄항공,28,28,56,6266,4948,11214,53,173,226
"2025","2",원통화물항공,21,20,41,0,0,0,503,227,730
"2025","2",유나이티드항공,55,55,110,12012,9856,21868,296,826,1123
"2025","2",유피에스항공,111,111,222,0,0,0,1273,1977,3250
"2025","2",이스타항공,509,506,1015,91415,86420,177835,25,14,38
"2025","2",일본항공,18,18,36,0,0,0,302,513,815
"2025","2",장쑤징동화물항공,36,36,72,0,0,0,553,128,681
"2025","2",전일본공수,24,24,48,0,0,0,683,786,1469
"2025","2",제주항공,1393,1385,2778,234044,216250,450294,219,150,369
"2025","2",젯스타,28,27,55,8323,8589,16912,32,99,131
"2025","2",중국국제항공,237,237,474,30936,29561,60497,46,78,124
"2025","2",중국남방항공,434,434,868,63394,61711,125105,359,114,473
"2025","2",중국동방항공,530,530,1060,73625,71106,144731,871,473,1344
"2025","2",중국센트럴항공,16,16,32,0,0,0,208,71,279
"2025","2",중국우정항공,27,27,54,0,0,0,330,142,472
"2025","2",중국해남항공,16,16,32,2417,1866,4283,1,0,1
"2025","2",중국화물항공,12,12,24,0,0,0,969,445,1414
"2025","2",중화항공,84,84,168,20518,21367,41885,495,391,886
"2025","2",진에어,1023,1025,2048,216860,211292,428152,756,571,1326
"2025","2",집에어,28,28,56,7805,7314,15119,275,149,424
"2025","2",천진항공,12,12,24,1188,1268,2456,0,0,0
"2025","2",천진화물항공,33,33,66,0,0,0,537,9,547
"2025","2",청도항공,26,26,52,3902,3405,7307,29,3,32
"2025","2",춘추항공,32,32,64,5233,4749,9982,2,3,5
"2025","2",카고룩스 이탈리아 항공,8,8,16,0,0,0,486,256,742
"2025","2",카고룩스항공,10,10,20,0,0,0,387,679,1066
"2025","2",카놋샤크,8,8,16,1115,400,1515,0,25,25
"2025","2",카타르항공,48,47,95,11186,9984,21170,1756,1488,3244
"2025","2",칼리타항공,75,76,151,0,0,0,1519,1641,3160
"2025","2",캐세이퍼시픽항공,115,115,230,26831,28448,55279,1192,689,1881
"2025","2",콴타스항공,16,16,32,3578,4720,8298,8,36,45
"2025","2",타이거에어 타이완,28,28,56,4566,4557,9123,5,16,21
"2025","2",타이에어아시아엑스,29,29,58,9745,7842,17587,384,57,441
"2025","2",타이항공,84,84,168,26641,24744,51385,1271,672,1943
"2025","2",터키항공,51,51,102,13936,11329,25265,1203,1233,2436
"2025","2",투르크메니스탄,2,2,4,0,0,0,17,63,80
"2025","2",티웨이항공,1000,998,1998,200336,189238,389574,928,663,1591
"2025","2",폴라에어카고,28,27,55,0,0,0,1209,1226,2435
"2025","2",폴란드항공,28,28,56,6253,4828,11081,208,221,429
"2025","2",피치항공,138,137,275,24060,21528,45588,0,8,8
"2025","2",핀에어,26,26,52,6119,4544,10663,594,354,948
"2025","2",필리핀에어아시아,39,39,78,5997,5635,11632,5,11,16
"2025","2",필리핀항공,140,140,280,28256,25657,53913,24,189,213
"2025","2",하와이안 항공,20,21,41,5006,4503,9509,38,230,269
"2025","2",홍콩익스프레스,84,84,168,17225,19193,36418,48,20,68
"2025","2",홍콩항공,49,49,98,8405,9584,17989,48,24,72
"2025","2",FedEX항공,116,116,232,0,0,0,3186,2850,6036
"2025","2",KLM네덜란드항공,20,20,40,5565,4884,10449,294,275,568
"2025","3",가루다인도네시아,46,46,92,9434,6768,16202,227,335,562
"2025","3",그레이터베이항공,2,2,4,285,41,326,1,0,1
"2025","3",대한항공,4088,4087,8175,762250,702773,1465023,55906,55717,111623
"2025","3",델타항공,155,157,312,40715,40640,81355,156,1640,1796
"2025","3",디에이치엘항공,1,1,2,0,0,0,0,0,0
"2025","3",라오항공,31,31,62,3962,2974,6936,6,6,12
"2025","3",로얄브루나이항공,13,13,26,1384,1045,2429,0,13,14
"2025","3",롱하오항공,70,70,140,0,0,0,1091,470,1561
"2025","3",루프트한자 독일항공,77,78,155,14042,13175,27217,757,1156,1913
"2025","3",말레이시아 항공,53,54,107,9216,6457,15673,444,613,1057
"2025","3",몽골항공,52,53,105,9026,8078,17104,38,202,240
"2025","3",미얀마국제항공,15,15,30,1781,1226,3007,2,6,8
"2025","3",미얀마항공,1,1,2,124,3,127,1,0,1
"2025","3",바틱 에어 말레이시아,24,24,48,3844,2218,6062,1,23,24
"2025","3",베트남항공,186,186,372,46664,41209,87873,1106,962,2069
"2025","3",비엣젯항공,465,463,928,96248,70833,167081,386,212,597
"2025","3",사천항공,12,12,24,1841,1599,3440,1,9,9
"2025","3",산동항공,265,264,529,37739,33006,70745,332,10,341
"2025","3",상하이항공,31,31,62,4860,4607,9467,15,0,15
"2025","3",샤먼항공,61,61,122,8319,6244,14563,54,20,74
"2025","3",세부퍼시픽항공,93,93,186,22013,16975,38988,95,351,447
"2025","3",순풍항공,37,37,74,0,0,0,707,280,987
"2025","3",스리랑카항공,9,9,18,1910,1473,3383,74,114,188
"2025","3",스위스 국제항공,11,11,22,2114,1995,4109,126,142,268
"2025","3",스카이 앙코르 항공,20,20,40,3297,2849,6146,0,9,9
"2025","3",스쿠트 항공,40,40,80,12781,10713,23494,176,206,382
"2025","3",실크웨이웨스트항공,9,9,18,0,0,0,913,863,1776
"2025","3",심천항공,66,66,132,9508,8232,17740,78,7,85
"2025","3",싱가포르항공,137,137,274,33239,27393,60632,1931,2027,3958
"2025","3",아메리칸항공,31,30,61,8055,7639,15694,17,265,281
"2025","3",아시아나항공,2460,2451,4911,483129,440512,923641,26071,25080,51151
"2025","3",아에로멕시코,30,30,60,5794,4911,10705,33,369,402
"2025","3",아틀라스항공,216,234,450,0,0,0,2197,1532,3729
"2025","3",안토노프항공,0,1,1,0,0,0,0,42,42
"2025","3",에미레이트항공,44,45,89,14313,12036,26349,409,649,1058
"2025","3",에바항공,119,119,238,26954,24781,51735,914,478,1392
"2025","3",에어 뉴질랜드,13,13,26,3434,2502,5936,31,222,253
"2025","3",에어 아스타나,39,39,78,5838,4686,10524,4,65,69
"2025","3",에어 프랑스,28,28,56,7890,6503,14393,384,345,729
"2025","3",에어로 몽골리아,10,10,20,1165,814,1979,0,0,0
"2025","3",에어로로직,39,39,78,0,0,0,2362,345,2708
"2025","3",에어로케이항공,43,42,85,6514,5676,12190,0,0,0
"2025","3",에어마카오,46,46,92,6178,5116,11294,56,9,65
"2025","3",에어부산,288,286,574,59312,56292,115604,5,17,23
"2025","3",에어서울,400,400,800,75983,75994,151977,109,56,164
"2025","3",에어아시아 버하드,32,31,63,4576,3731,8307,0,0,0
"2025","3",에어아시아엑스,38,38,76,12044,7491,19535,249,336,585
"2025","3",에어인디아 리미티드,18,18,36,4508,2673,7181,114,231,345
"2025","3",에어인천,165,166,331,0,0,0,2594,1584,4178
"2025","3",에어재팬,31,31,62,9308,8163,17471,154,138,292
"2025","3",에어캐나다,54,55,109,15125,16031,31156,296,460,755
"2025","3",에어프레미아,134,132,266,36338,33734,70072,1135,1147,2282
"2025","3",에어홍콩,26,26,52,0,0,0,1168,1222,2390
"2025","3",에티오피아항공,67,67,134,4984,3683,8667,1134,437,1571
"2025","3",에티하드 항공,45,45,90,10929,6789,17718,564,663,1227
"2025","3",우즈베키스탄항공,30,30,60,6607,5826,12433,63,195,257
"2025","3",원통화물항공,26,27,53,0,0,0,659,305,964
"2025","3",유나이티드항공,62,61,123,15094,13557,28651,369,1006,1376
"2025","3",유피에스항공,122,124,246,0,0,0,1588,2562,4150
"2025","3",이스타항공,502,501,1003,86613,81626,168239,10,19,29
"2025","3",일본항공,21,21,42,0,0,0,358,706,1064
"2025","3",장쑤징동화물항공,46,46,92,0,0,0,751,166,918
"2025","3",전일본공수,26,26,52,0,0,0,750,925,1674
"2025","3",제주항공,1443,1436,2879,235759,214848,450607,242,176,418
"2025","3",젯스타,30,31,61,8781,8162,16943,18,252,270
"2025","3",중국국제항공,259,259,518,37060,30753,67813,101,101,201
"2025","3",중국남방항공,409,409,818,60491,57208,117699,489,118,607
"2025","3",중국동방항공,548,548,1096,82674,71739,154413,1078,460,1538
"2025","3",중국센트럴항공,25,25,50,0,0,0,404,162,567
"2025","3",중국우정항공,28,28,56,0,0,0,383,155,538
"2025","3",중국해남항공,18,18,36,2521,1382,3903,1,3,4
"2025","3",중국화물항공,22,22,44,0,0,0,1878,799,2678
"2025","3",중화항공,94,93,187,22004,20477,42481,660,460,1119
"2025","3",진에어,1041,1035,2076,230018,220252,450270,1095,769,1865
"2025","3",집에어,31,31,62,8555,8320,16875,320,227,547
"2025","3",천진항공,12,12,24,1361,1271,2632,0,0,0
"2025","3",천진화물항공,41,41,82,0,0,0,691,8,700
"2025","3",청도항공,29,29,58,4210,3863,8073,28,2,29
"2025","3",춘추항공,35,35,70,5929,5287,11216,5,5,10
"2025","3",카고룩스 이탈리아 항공,14,14,28,0,0,0,948,542,1491
"2025","3",카고룩스항공,14,14,28,0,0,0,679,989,1668
"2025","3",카놋샤크,9,9,18,1269,669,1938,0,21,21
"2025","3",카타르항공,52,53,105,10878,9596,20474,1857,2078,3935
"2025","3",칼리타항공,121,121,242,0,0,0,1384,1744,3129
"2025","3",캐세이퍼시픽항공,134,134,268,34027,29506,63533,1535,841,2376
"2025","3",콴타스항공,17,17,34,4103,2774,6877,6,135,141
"2025","3",타이거에어 타이완,31,31,62,5198,3564,8762,5,35,40
"2025","3",타이에어아시아엑스,31,31,62,8908,6001,14909,448,104,553
"2025","3",타이항공,93,93,186,28367,21278,49645,1343,794,2137
"2025","3",터키항공,58,59,117,15116,12946,28062,1499,1673,3172
"2025","3",투르크메니스탄,5,5,10,0,0,0,87,167,254
"2025","3",티웨이항공,1048,1045,2093,211341,194439,405780,1118,1119,2237
"2025","3",폴라에어카고,31,32,63,0,0,0,1278,1042,2320
"2025","3",폴란드항공,30,30,60,6259,5402,11661,217,328,545
"2025","3",피치항공,155,156,311,25597,25138,50735,0,10,10
"2025","3",핀에어,28,28,56,5341,4723,10064,609,438,1046
"2025","3",필리핀에어아시아,31,31,62,4180,3616,7796,4,12,16
"2025","3",필리핀항공,74,74,148,15021,12944,27965,41,141,182
"2025","3",하와이안 항공,23,23,46,5233,4691,9924,30,347,377
"2025","3",홍콩익스프레스,93,93,186,20536,18062,38598,71,23,95
"2025","3",홍콩항공,46,46,92,8139,7002,15141,90,29,118
"2025","3",FedEX항공,156,153,309,0,0,0,4115,3562,7676
"2025","3",KLM네덜란드항공,22,22,44,5941,5897,11838,337,280,618
"2025","3",ZP,1,1,2,0,0,0,24,0,24
"2025","4",가루다인도네시아,50,50,100,8939,11441,20380,130,339,470
"2025","4",그레이터베이항공,5,5,10,879,646,1525,0,0,0
"2025","4",내셔널항공,2,2,4,0,0,0,68,40,108
"2025","4",대한항공,3834,3831,7665,700083,722345,1422428,51324,52124,103447
"2025","4",델타항공,150,155,305,38184,42409,80593,152,1633,1785
"2025","4",디에이치엘항공,1,1,2,0,0,0,85,0,85
"2025","4",라오항공,21,21,42,2916,2642,5558,11,8,19
"2025","4",로얄브루나이항공,14,14,28,1315,1758,3073,1,6,7
"2025","4",롱하오항공,50,50,100,0,0,0,744,432,1175
"2025","4",루프트한자 독일항공,86,87,173,15705,16091,31796,952,1235,2187
"2025","4",말레이시아 항공,49,48,97,8532,10784,19316,509,591,1100
"2025","4",몽골항공,52,52,104,7930,9370,17300,41,202,244
"2025","4",미얀마국제항공,15,15,30,1347,1394,2741,2,5,8
"2025","4",바틱 에어 말레이시아,30,30,60,3907,3926,7833,0,25,25
"2025","4",베트남항공,180,180,360,43024,44378,87402,1058,978,2036
"2025","4",비엣젯항공,450,448,898,88020,74607,162627,403,172,576
"2025","4",사천항공,13,13,26,1845,1851,3696,2,9,11
"2025","4",산동항공,291,290,581,39114,40424,79538,271,10,281
"2025","4",상하이항공,30,30,60,4641,4772,9413,4,0,4
"2025","4",샤먼항공,59,59,118,8497,7673,16170,49,21,70
"2025","4",세부퍼시픽항공,90,90,180,22108,21101,43209,102,283,385
"2025","4",순풍항공,44,45,89,0,0,0,737,312,1050
"2025","4",스리랑카항공,9,9,18,1502,2135,3637,102,104,205
"2025","4",스위스 국제항공,13,13,26,2519,2662,5181,166,175,341
"2025","4",스카이 앙코르 항공,21,21,42,3388,3302,6690,4,9,13
"2025","4",스쿠트 항공,44,44,88,14428,14503,28931,336,227,563
"2025","4",실크웨이웨스트항공,9,9,18,0,0,0,918,941,1859
"2025","4",심천항공,67,67,134,9395,9658,19053,68,11,78
"2025","4",싱가포르항공,145,145,290,34236,37181,71417,2486,2111,4597
"2025","4",아메리칸항공,30,31,61,7285,7584,14869,20,264,284
"2025","4",아시아나항공,2311,2313,4624,425312,446487,871799,23798,22986,46784
"2025","4",아에로멕시코,30,30,60,6490,6569,13059,32,267,299
"2025","4",아틀라스항공,261,276,537,0,0,0,2678,1469,4147
"2025","4",에미레이트항공,43,43,86,14606,18127,32733,563,617,1180
"2025","4",에바항공,97,97,194,20689,23408,44097,894,369,1262
"2025","4",에어 아스타나,34,34,68,5311,6091,11402,13,152,164
"2025","4",에어 프랑스,30,30,60,8071,8074,16145,466,390,855
"2025","4",에어로 몽골리아,8,8,16,592,817,1409,0,1,1
"2025","4",에어로로직,28,28,56,0,0,0,2115,210,2325
"2025","4",에어로케이항공,65,66,131,7419,7245,14664,0,0,0
"2025","4",에어마카오,48,48,96,5803,5648,11451,57,7,64
"2025","4",에어부산,196,197,393,40419,41229,81648,33,1,34
"2025","4",에어서울,386,388,774,71756,73370,145126,116,30,146
"2025","4",에어아시아 버하드,29,30,59,3254,3444,6698,0,0,0
"2025","4",에어아시아엑스,43,43,86,14093,14773,28866,235,356,591
"2025","4",에어인디아 리미티드,21,21,42,4811,3569,8380,162,235,397
"2025","4",에어인천,178,176,354,0,0,0,2871,1362,4233
"2025","4",에어재팬,30,30,60,8356,7031,15387,150,117,267
"2025","4",에어캐나다,56,56,112,15055,16612,31667,318,432,751
"2025","4",에어프레미아,119,122,241,31548,34745,66293,980,1210,2191
"2025","4",에어홍콩,26,26,52,0,0,0,1103,1134,2236
"2025","4",에티오피아항공,61,61,122,4649,3804,8453,1077,327,1404
"2025","4",에티하드 항공,47,47,94,10561,12385,22946,537,739,1276
"2025","4",우즈베키스탄항공,30,30,60,6884,7002,13886,53,245,297
"2025","4",원통화물항공,25,25,50,0,0,0,661,311,973
"2025","4",웨스트젯,13,13,26,4100,4103,8203,7,165,172
"2025","4",유나이티드항공,60,61,121,13218,15399,28617,349,1124,1474
"2025","4",유피에스항공,119,120,239,0,0,0,1495,2422,3916
"2025","4",이스타항공,438,437,875,71142,73081,144223,32,71,103
"2025","4",일본항공,21,21,42,0,0,0,354,733,1087
"2025","4",장쑤징동화물항공,37,37,74,0,0,0,566,164,730
"2025","4",전일본공수,26,26,52,0,0,0,770,913,1683
"2025","4",제주항공,1259,1256,2515,202490,202291,404781,169,150,320
"2025","4",젯스타,30,30,60,9031,8077,17108,23,236,259
"2025","4",중국국제항공,266,266,532,35038,35943,70981,59,67,126
"2025","4",중국남방항공,420,420,840,58340,64096,122436,474,129,603
"2025","4",중국동방항공,555,554,1109,80908,82793,163701,1034,507,1541
"2025","4",중국센트럴항공,34,34,68,0,0,0,589,179,767
"2025","4",중국우정항공,13,13,26,0,0,0,115,149,264
"2025","4",중국해남항공,17,17,34,2545,1644,4189,2,0,2
"2025","4",중국화물항공,19,19,38,0,0,0,1622,662,2284
"2025","4",중화항공,90,90,180,22410,24469,46879,773,568,1341
"2025","4",진에어,969,967,1936,203488,205901,409389,456,528,983
"2025","4",집에어,30,30,60,7957,7227,15184,270,202,472
"2025","4",천진항공,11,11,22,1244,1201,2445,0,0,0
"2025","4",천진화물항공,21,21,42,0,0,0,346,2,348
"2025","4",청도항공,30,30,60,3772,4367,8139,17,3,21
"2025","4",춘추항공,35,35,70,5672,5600,11272,4,2,6
"2025","4",카고룩스 이탈리아 항공,11,12,23,0,0,0,636,453,1089
"2025","4",카고룩스항공,12,12,24,0,0,0,561,1032,1593
"2025","4",카놋샤크,8,8,16,1114,1200,2314,0,14,14
"2025","4",카타르항공,51,51,102,11912,12215,24127,1869,1848,3716
"2025","4",칼리타항공,81,82,163,0,0,0,1314,1914,3228
"2025","4",캐세이퍼시픽항공,132,132,264,33572,34893,68465,1463,788,2251
"2025","4",콴타스항공,13,13,26,3314,3265,6579,8,89,97
"2025","4",타이거에어 타이완,30,30,60,5004,4494,9498,5,29,34
"2025","4",타이에어아시아엑스,30,30,60,6901,6597,13498,483,125,608
"2025","4",타이항공,81,81,162,22642,22501,45143,1531,1006,2537
"2025","4",터키항공,55,55,110,15412,14969,30381,1271,1513,2784
"2025","4",투르크메니스탄,3,3,6,0,0,0,62,112,174
"2025","4",티웨이항공,932,935,1867,175337,180206,355543,1209,941,2150
"2025","4",폴라에어카고,23,23,46,0,0,0,749,665,1414
"2025","4",폴란드항공,30,30,60,7111,7091,14202,154,346,501
"2025","4",피치항공,150,150,300,25073,23064,48137,0,10,10
"2025","4",핀에어,28,28,56,6554,7342,13896,576,396,972
"2025","4",필리핀에어아시아,30,30,60,4105,3956,8061,2,2,4
"2025","4",필리핀항공,64,63,127,14331,15639,29970,25,209,235
"2025","4",하와이안 항공,21,21,42,3893,4889,8782,29,294,323
"2025","4",홍콩익스프레스,94,94,188,20531,20508,41039,52,30,82
"2025","4",홍콩항공,54,54,108,8824,9308,18132,108,32,140
"2025","4",FedEX항공,153,154,307,0,0,0,3647,3237,6884
"2025","4",KLM네덜란드항공,21,21,42,7188,7227,14415,430,347,777
"2025","4",ZP,1,1,2,0,0,0,30,15,46
"2025","5",가루다인도네시아,40,40,80,7626,7840,15466,164,204,368
"2025","5",그레이터베이항공,4,4,8,730,728,1458,0,0,0
"2025","5",내셔널항공,1,1,2,0,0,0,113,0,113
"2025","5",대한항공,4012,4011,8023,736447,727687,1464134,54177,51874,106052
"2025","5",델타항공,153,156,309,41886,39410,81296,171,1798,1969
"2025","5",라오항공,23,23,46,3077,3026,6103,27,18,45
"2025","5",로얄브루나이항공,13,13,26,1270,1227,2497,0,8,8
"2025","5",롱하오항공,67,67,134,0,0,0,1049,404,1454
"2025","5",루프트한자 독일항공,84,83,167,16708,17332,34040,963,1135,2098
"2025","5",말레이시아 항공,53,53,106,8826,9516,18342,464,555,1019
"2025","5",몽골항공,68,67,135,9572,10362,19934,39,218,257
"2025","5",미얀마국제항공,15,15,30,1133,1242,2375,6,7,14
"2025","5",미얀마항공,2,2,4,295,2,297,0,1,1
"2025","5",바틱 에어 말레이시아,25,25,50,3638,2838,6476,4,20,24
"2025","5",베트남항공,186,186,372,40815,43318,84133,1088,1045,2134
"2025","5",비엣젯항공,435,434,869,81128,72320,153448,311,141,452
"2025","5",사천항공,14,14,28,1983,1985,3968,2,9,11
"2025","5",산동항공,303,303,606,39277,40963,80240,390,11,401
"2025","5",상하이항공,31,31,62,4786,4884,9670,7,0,7
"2025","5",샤먼항공,53,53,106,7635,6640,14275,53,14,67
"2025","5",세부퍼시픽항공,89,90,179,20566,17849,38415,79,336,415
"2025","5",순풍항공,42,42,84,0,0,0,757,307,1064
"2025","5",스리랑카항공,8,8,16,1759,1410,3169,98,89,187
"2025","5",스위스 국제항공,13,13,26,2626,2745,5371,130,160,290
"2025","5",스카이 앙코르 항공,15,15,30,2634,1806,4440,2,6,8
"2025","5",스캇항공,1,1,2,122,91,213,0,0,0
"2025","5",스쿠트 항공,39,39,78,13468,11916,25384,318,244,562
"2025","5",실크웨이웨스트항공,9,9,18,0,0,0,838,925,1763
"2025","5",심천항공,75,75,150,10351,10168,20519,69,6,74
"2025","5",싱가포르항공,152,152,304,35964,37036,73000,2615,2216,4830
"2025","5",아메리칸항공,31,31,62,7656,7688,15344,22,307,329
"2025","5",아시아나항공,2444,2444,4888,446137,445326,891463,24559,24053,48612
"2025","5",아에로멕시코,27,27,54,5115,5590,10705,67,252,319
"2025","5",아틀라스항공,191,213,404,0,0,0,2208,2415,4623
"2025","5",에미레이트항공,44,43,87,16890,17638,34528,549,609,1158
"2025","5",에바항공,93,93,186,19199,18497,37696,822,365,1186
"2025","5",에어 아스타나,35,35,70,5289,5705,10994,8,143,152
"2025","5",에어 프랑스,31,31,62,8043,8668,16711,458,386,844
"2025","5",에어로 몽골리아,13,13,26,1062,1222,2284,0,0,0
"2025","5",에어로로직,31,31,62,0,0,0,2338,59,2396
"2025","5",에어로케이항공,69,68,137,6522,6766,13288,0,0,0
"2025","5",에어마카오,50,51,101,6009,5500,11509,68,6,74
"2025","5",에어부산,205,204,409,41062,41431,82493,28,13,42
"2025","5",에어서울,398,396,794,72959,73519,146478,118,13,131
"2025","5",에어아시아 버하드,31,31,62,3168,2519,5687,0,0,0
"2025","5",에어아시아엑스,35,35,70,11341,9924,21265,247,295,542
"2025","5",에어인디아 리미티드,23,23,46,5182,4095,9277,132,261,392
"2025","5",에어인천,98,98,196,0,0,0,1484,1258,2742
"2025","5",에어재팬,31,31,62,8255,6776,15031,148,170,317
"2025","5",에어캐나다,59,59,118,16936,17018,33954,277,500,777
"2025","5",에어프레미아,156,157,313,44653,43617,88270,1420,1455,2875
"2025","5",에어홍콩,26,26,52,0,0,0,1035,1148,2183
"2025","5",에티오피아항공,64,65,129,6181,5376,11557,1067,400,1467
"2025","5",에티하드 항공,48,49,97,12823,13265,26088,562,687,1248
"2025","5",우즈베키스탄항공,31,31,62,6751,6926,13677,66,176,242
"2025","5",원통화물항공,32,32,64,0,0,0,855,427,1281
"2025","5",웨스트젯,22,22,44,6726,6876,13602,19,282,301
"2025","5",유나이티드항공,62,62,124,15196,13172,28368,510,1236,1746
"2025","5",유피에스항공,124,123,247,0,0,0,1552,2424,3976
"2025","5",이스타항공,473,462,935,77695,77516,155211,13,43,56
"2025","5",일본항공,25,25,50,0,0,0,427,841,1268
"2025","5",장쑤징동화물항공,42,42,84,0,0,0,693,200,893
"2025","5",전일본공수,26,26,52,0,0,0,723,910,1633
"2025","5",제주항공,1387,1386,2773,227037,225281,452318,157,173,330
"2025","5",젯스타,31,31,62,9485,8965,18450,72,254,325
"2025","5",중국국제항공,278,278,556,36948,38313,75261,85,62,147
"2025","5",중국남방항공,424,424,848,59416,63740,123156,484,98,582
"2025","5",중국동방항공,602,603,1205,86983,88133,175116,1263,541,1804
"2025","5",중국센트럴항공,18,18,36,0,0,0,315,152,466
"2025","5",중국우정항공,12,12,24,0,0,0,95,127,222
"2025","5",중국해남항공,18,18,36,2337,1265,3602,0,1,1
"2025","5",중국화물항공,16,16,32,0,0,0,1361,586,1947
"2025","5",중화항공,97,97,194,23635,22581,46216,753,569,1321
"2025","5",진에어,1010,1009,2019,209359,207330,416689,421,634,1055
"2025","5",집에어,31,31,62,7918,7334,15252,222,198,419
"2025","5",천진항공,17,17,34,1876,1874,3750,0,0,0
"2025","5",천진화물항공,22,22,44,0,0,0,396,0,396
"2025","5",청도항공,29,29,58,3669,3909,7578,28,3,31
"2025","5",춘추항공,35,35,70,5777,5517,11294,4,4,8
"2025","5",카고룩스 이탈리아 항공,10,10,20,0,0,0,665,348,1013
"2025","5",카고룩스항공,13,13,26,0,0,0,672,1163,1836
"2025","5",카놋샤크,9,9,18,981,1141,2122,0,30,30
"2025","5",카타르항공,52,51,103,12306,12992,25298,1699,1760,3459
"2025","5",칼리타항공,76,76,152,0,0,0,1107,2156,3263
"2025","5",캐세이퍼시픽항공,126,126,252,29886,29511,59397,1496,859,2355
"2025","5",콴타스항공,2,2,4,499,601,1100,2,4,6
"2025","5",타이거에어 타이완,31,31,62,5330,4286,9616,6,26,32
"2025","5",타이에어아시아엑스,31,31,62,7709,6525,14234,519,149,668
"2025","5",타이항공,70,70,140,18387,15923,34310,1352,878,2231
"2025","5",터키항공,58,58,116,16221,16010,32231,1335,1551,2886
"2025","5",투르크메니스탄,3,3,6,0,0,0,22,98,119
"2025","5",티웨이항공,985,984,1969,194842,197424,392266,1774,1084,2858
"2025","5",폴라에어카고,23,23,46,0,0,0,794,715,1509
"2025","5",폴란드항공,31,31,62,6763,7513,14276,131,369,500
"2025","5",피치항공,156,156,312,25940,22297,48237,0,9,9
"2025","5",핀에어,28,28,56,7155,7380,14535,633,396,1029
"2025","5",필리핀에어아시아,31,31,62,4397,3966,8363,4,3,7
"2025","5",필리핀항공,94,94,188,18336,17855,36191,38,170,209
"2025","5",하와이안 항공,22,22,44,5427,4642,10069,62,274,336
"2025","5",홍콩익스프레스,91,91,182,20300,19325,39625,53,27,80
"2025","5",홍콩항공,43,43,86,7138,6435,13573,61,16,77
"2025","5",FedEX항공,144,144,288,0,0,0,3368,3250,6618
"2025","5",KLM네덜란드항공,29,29,58,8786,9530,18316,516,426,943
"2025","6",가루다인도네시아,40,40,80,8331,8409,16740,103,211,313
"2025","6",내셔널항공,2,4,6,0,0,0,0,194,194
"2025","6",대한항공,3929,3932,7861,712487,707654,1420141,53737,52053,105790
"2025","6",델타항공,168,172,340,46105,44396,90501,348,1698,2046
"2025","6",라오항공,21,21,42,2660,2752,5412,7,11,19
"2025","6",로얄브루나이항공,12,12,24,905,1009,1914,0,12,12
"2025","6",롱하오항공,58,58,116,0,0,0,848,314,1162
"2025","6",루프트한자 독일항공,88,88,176,15986,16661,32647,944,1365,2309
"2025","6",마스에어,18,18,36,0,0,0,0,0,0
"2025","6",말레이시아 항공,50,51,101,7706,9920,17626,427,556,983
"2025","6",몽골항공,87,87,174,15076,15974,31050,20,234,254
"2025","6",미얀마국제항공,14,14,28,1397,1303,2700,4,6,10
"2025","6",미얀마항공,2,2,4,272,1,273,1,1,1
"2025","6",바틱 에어 말레이시아,23,23,46,3330,3147,6477,2,28,30
"2025","6",베트남항공,180,180,360,43074,46411,89485,1093,960,2053
"2025","6",비엣젯항공,415,415,830,80108,78720,158828,357,120,477
"2025","6",사천항공,12,12,24,1821,1769,3590,5,10,15
"2025","6",산동항공,300,300,600,36453,42903,79356,417,13,431
"2025","6",상하이항공,30,30,60,4630,4763,9393,17,0,18
"2025","6",샤먼항공,53,53,106,7439,7977,15416,47,17,64
"2025","6",세부퍼시픽항공,75,75,150,17061,15322,32383,117,299,416
"2025","6",순풍항공,42,42,84,0,0,0,692,387,1079
"2025","6",스리랑카항공,9,9,18,1448,1694,3142,111,108,220
"2025","6",스위스 국제항공,13,13,26,2568,2719,5287,131,168,298
"2025","6",스카이 앙코르 항공,11,11,22,1624,1451,3075,1,4,5
"2025","6",스캇항공,8,8,16,714,694,1408,0,0,0
"2025","6",스쿠트 항공,39,39,78,13453,12801,26254,268,222,490
"2025","6",실크웨이웨스트항공,9,9,18,0,0,0,649,932,1581
"2025","6",심천항공,73,73,146,9889,10026,19915,68,6,74
"2025","6",싱가포르항공,145,145,290,33669,36999,70668,2222,2010,4232
"2025","6",아메리칸항공,31,31,62,8219,7827,16046,19,265,284
"2025","6",아시아나항공,2388,2383,4771,447876,439938,887814,25461,24386,49847
"2025","6",아에로멕시코,26,26,52,5615,5419,11034,44,194,238
"2025","6",아틀라스항공,226,238,464,0,0,0,3112,1833,4945
"2025","6",에미레이트항공,43,43,86,16502,17606,34108,572,584,1156
"2025","6",에바항공,90,90,180,20242,20165,40407,701,358,1059
"2025","6",에어 아스타나,44,44,88,6279,6578,12857,11,167,178
"2025","6",에어 프랑스,30,30,60,8147,8353,16500,405,340,745
"2025","6",에어로 몽골리아,26,26,52,2746,2474,5220,0,2,2
"2025","6",에어로로직,31,31,62,0,0,0,2387,132,2519
"2025","6",에어로케이항공,60,60,120,5949,6186,12135,0,0,0
"2025","6",에어마카오,50,49,99,6364,6299,12663,81,4,85
"2025","6",에어부산,198,197,395,40820,40961,81781,25,22,47
"2025","6",에어서울,384,382,766,71300,70767,142067,103,34,137
"2025","6",에어아시아 버하드,26,26,52,3287,3249,6536,0,0,0
"2025","6",에어아시아엑스,35,35,70,10421,10440,20861,219,301,520
"2025","6",에어인디아 리미티드,16,16,32,3681,3227,6908,65,169,233
"2025","6",에어인천,97,98,195,0,0,0,1413,1206,2619
"2025","6",에어재팬,30,30,60,7537,5882,13419,134,144,278
"2025","6",에어캐나다,73,73,146,20652,20069,40721,455,572,1027
"2025","6",에어프레미아,169,168,337,46536,44535,91071,1789,1614,3403
"2025","6",에어홍콩,25,25,50,0,0,0,1019,1104,2123
"2025","6",에티오피아항공,61,61,122,6717,5392,12109,1105,390,1495
"2025","6",에티하드 항공,48,47,95,12795,12656,25451,586,686,1272
"2025","6",우즈베키스탄항공,30,30,60,6451,6026,12477,55,143,198
"2025","6",원통화물항공,25,25,50,0,0,0,672,175,847
"2025","6",웨스트젯,26,26,52,7966,7935,15901,10,352,361
"2025","6",유나이티드항공,60,60,120,15314,13818,29132,565,1016,1580
"2025","6",유피에스항공,132,132,264,0,0,0,1734,2474,4208
"2025","6",이스타항공,482,481,963,81879,83276,165155,7,44,51
"2025","6",일본항공,25,25,50,0,0,0,435,901,1336
"2025","6",장쑤징동화물항공,33,33,66,0,0,0,561,210,771
"2025","6",전일본공수,25,25,50,0,0,0,750,883,1633
"2025","6",제주항공,1453,1444,2897,237280,233427,470707,146,214,360
"2025","6",젯스타,36,36,72,11370,10121,21491,43,245,288
"2025","6",중국국제항공,274,274,548,37116,38763,75879,103,66,169
"2025","6",중국남방항공,434,434,868,59857,67929,127786,473,102,575
"2025","6",중국동방항공,589,588,1177,87823,90614,178437,1271,451,1723
"2025","6",중국센트럴항공,21,21,42,0,0,0,351,178,528
"2025","6",중국연합항공,6,6,12,896,1072,1968,0,0,0
"2025","6",중국우정항공,15,15,30,0,0,0,164,139,303
"2025","6",중국해남항공,13,13,26,1720,1604,3324,0,1,1
"2025","6",중국화물항공,16,16,32,0,0,0,1382,559,1940
"2025","6",중화항공,90,90,180,23871,23091,46962,707,556,1263
"2025","6",진에어,921,919,1840,191561,187705,379266,411,582,993
"2025","6",집에어,30,30,60,7497,6529,14026,232,207,439
"2025","6",천진항공,18,18,36,1886,1954,3840,0,0,0
"2025","6",천진화물항공,21,21,42,0,0,0,375,1,376
"2025","6",청도항공,30,30,60,3527,4635,8162,41,3,44
"2025","6",춘추항공,34,34,68,5625,5727,11352,6,5,11
"2025","6",카고룩스 이탈리아 항공,14,14,28,0,0,0,956,504,1460
"2025","6",카고룩스항공,13,13,26,0,0,0,608,1134,1741
"2025","6",카놋샤크,13,13,26,1277,1878,3155,5,51,55
"2025","6",카타르항공,49,49,98,11242,11551,22793,1174,1664,2838
"2025","6",칼리타항공,107,107,214,0,0,0,1583,2366,3948
"2025","6",캐세이퍼시픽항공,125,125,250,32937,31824,64761,1091,815,1906
"2025","6",타이거에어 타이완,30,30,60,5109,4273,9382,3,22,25
"2025","6",타이에어아시아엑스,25,25,50,6417,5372,11789,412,134,546
"2025","6",타이항공,89,89,178,18707,18063,36770,1661,918,2579
"2025","6",터키항공,56,56,112,15643,14748,30391,1406,1593,2999
"2025","6",투르크메니스탄,4,4,8,0,0,0,24,138,162
"2025","6",티웨이항공,933,931,1864,189249,188287,377536,1689,1253,2941
"2025","6",폴라에어카고,21,21,42,0,0,0,770,709,1479
"2025","6",폴란드항공,30,30,60,6458,6469,12927,211,345,556
"2025","6",피치항공,151,151,302,24498,18711,43209,0,8,8
"2025","6",핀에어,30,30,60,8474,8125,16599,535,388,922
"2025","6",필리핀에어아시아,30,30,60,4130,4278,8408,4,10,14
"2025","6",필리핀항공,90,90,180,16402,18216,34618,35,105,140
"2025","6",하와이안 항공,22,22,44,5350,4861,10211,61,269,330
"2025","6",홍콩익스프레스,84,84,168,18489,18259,36748,46,22,69
"2025","6",홍콩항공,34,34,68,5820,5349,11169,60,13,72
"2025","6",FedEX항공,148,148,296,0,0,0,3526,3074,6601
"2025","6",GM,1,0,1,0,0,0,2,0,2
"2025","6",KLM네덜란드항공,30,30,60,9350,9461,18811,204,441,645
